阿斗当皇帝	软弱无能
阿斗的江山	白送
阿二（民间传说中的呆头呆脑、自作聪明的人）炒年糕	费力不讨好；费劲不落好
阿公吃黄连	苦也（爷）
阿拉伯数字8字分家	零比零（O：O）
阿奶抱孙子	老手
阿婆的鞋	老样子
阿婆留胡子	反常
阿庆嫂倒茶	滴水不漏
挨鞭子不挨棍子	吃软不吃硬
挨打的狗去咬鸡	拿别人出气
挨打的山鸡	顾头不顾尾
挨了巴掌赔不是	奴颜媚骨
挨了棒的狗	垂头丧气；气急败坏
挨了打的鸭子	乱窜
挨了刀的肥猪	不怕开水烫
挨了刀的皮球	瘪了
挨了霜的狗尾巴草	蔫了
挨着火炉吃海椒（辣椒）	里外发烧
矮夫矬（cuo 矮）妻	各有短处
矮梯子上高房	搭不上盲（檐）
矮子不吃馒头	想高（糕）
矮子踩高跷	取长补短
矮子穿长袍	拖拖拉拉
矮子穿木屐（mu ji木板拖鞋）	自高自大
矮子打呵欠	气儿不长
矮子打墙	只有一半
矮子放屁	低声下气
矮子跟着长子（身材高的人）走	多跑几步路
矮子过河	安（淹）心
矮子看戏	人云亦云
矮子里面拔将军	将就材料；短中取长
矮子面前说短话	惹人多
矮子爬坡	步步高升
矮子排队	倒数第一
矮子骑大马	上下两难；上下为难
矮子上楼梯	步步高升
矮子推掌	出手不高
矮子坐高凳	上下够不着，上下为难
爱吃香的有腊肠，爱吃甜的有蜜糖	对味
爱打半边鼓	旁敲侧击
爱叫的鸟	不做窝
安禄山起兵	反了
庵庙里的尼姑	没福（夫）
庵堂（尼姑庵）里的木鱼	任人敲打
岸边的青蛙	一触即跳
岸上看人溺水	见死不救
岸上捞月	白费功夫
按鸡头啄米	白费心机（比喻不能强迫人去做不愿做的事。）
按老方子吃药	还是老一套
按下葫芦起了瓢	顾了这头丢那头；此起彼落；此起彼伏；顾此失彼
按着葫芦挖籽	挖一个少一个
按着脑袋往火炕里钻	憋气窝火
按着牛头喝水	勉强不得
案板底下放风筝	飞不起来
案板顶门	管得宽
案板上的擀面杖	光棍一条
案板上的狗肉	上不了席
案板上的肉	任人宰割
案板上砍骨头	干干脆脆
案上砍骨头	干脆利索；干脆
暗地里耍拳	瞎打一阵
暗洞里裹脚	瞎缠
暗室里穿针	难过
暗锁加明锁	层层设防
暗滩上行船	危险性大
暗屋里穿针	难过
暗中使绊子	蔫（nian悄悄地；不声不响地）坏
肮脏他娘哭一夜	肮脏死啦
鏊子（ao zi烙饼的炊具。铁制圆形平底）里摊饼	不敢（擀）
鏊子上烙冰	化汤了
鏊子上烙饼	翻来覆去
八磅大锤钉钉子	稳扎稳打
八宝饭掺糨子（jiang zi糨糊）	糊涂到儿了
八宝饭里撒盐巴	又添一味
八十岁老太学吹打	上气不接下气
八十岁奶奶搽胭脂	老来俏
八尺沟滨（bang小河）六尺跳板	搭不上
八哥的嘴巴	随人说话；能说会道
八哥啄柿子	拣软的欺
八个麻雀抬轿	担当不起
八个钱算命	哪能包你
八股文的格式	千篇一律
八虎（《杨宋将》中杨继业的八个儿子）闯幽州	死的死，丢的丢（比喻损失太大。）
八里庄的萝卜	心里美
八亩地里一棵谷	就这一
八匹马拉不开	难分难解
八千岁留胡子	大主意个人拿
八十老太学吹打	上气不接下气
八十老翁吹喇叭	有气无力
八十岁比高低	老当益壮
八十岁吹喇叭	寿长气短
八十岁的阿婆	老掉牙了
八十岁公公耍猴子	老把戏
八十岁公公挑担子	心有余而力不足
八十岁考状元	人老心不老
八十岁老人进幼儿园	返老还童
八十岁老翁吹喇叭	有气无力
八十岁老翁学手艺	老来发奋
八十岁没儿女	老来孤单
八十岁跳舞	老天真
八十岁站柜台	老在行
八仙过海	各显神通；能行风的行风，能下雨的下雨
八仙过海不用船	自有法度（渡）
八仙桌缺只脚	摆不平
八仙桌上摆夜壶	不是个（家）伙；不是个成就（盛酒）的家伙
八仙桌上放盏灯	明摆着
八旬奶奶三岁孙	老的老，小的小
八月的柿子	越老越红
八月的丝瓜	黑心
八月的天气	一会儿晴，一会儿阴
八月桂花开	到处飘香
八月间的核桃	满人（仁）
八月里的黄瓜棚	空架子
八月十五办年货	赶早不赶晚
八月十五吃月饼	正是时候
八月十五吃粽子	不是时候
八月十五桂花香	花好月圆
八月十五过年	差远了
八月十五看龙灯	迟了大半年（比喻太晚来不及了。）
八月十五团圆节	一年一回
八月十五种花生	瞎指挥
八月十五捉兔子	有你过节，无你也过节（比喻有没有无关大局。）
八张牌摊开打	来明的
八只脚的螃蟹	横行霸道
八字写一撇	少一半
巴掌被蚊咬	手痒
巴掌长疮	毒手
巴掌穿鞋	行不通
巴掌打空气	劳而无功
巴掌蒙眼睛	其实遮不住天
巴掌劈砖头	硬功夫
巴掌心煎鸡蛋	巧手；好手
叭拉狗蹲墙头	硬装坐地虎（比喻冒充豪绅）
叭拉狗掀门帘	全仗一张嘴
叭拉狗咬月亮	不知天多高（比喻不知道自己有多大本事，非常不自量力
扒灰头讲礼书	说里不走理
扒了皮的癞蛤蟆	活着讨厌，死了还吓人
扒了墙的庙	慌了神
芭蕉插在古树上	粗枝大叶
芭蕉结果	紧连心；一条心
芭蕉敲鼓	面面点到
疤瘌眼照镜子	自找难看
疤上生疮	根底坏
拔河比赛	两头拉
拔节的竹笋	天天向上
拔了萝卜窟窿在	有根有
拔了萝卜有眼在	不得白用力
拔了萝卜栽上葱	一茬比一茬辣
拔了毛的凤凰	不如鸡
拔了毛的鸽子	看你昨飞
拔了毛的狮子	惹你笑
把鼻涕往脸上抹	自找难看
把镰刀卡在喉咙里	吞又吞不下,吐又吐不出来
把牛角安在驴头上	四不像
把手插在磨眼里	自找苦吃
把它当枕头	置之脑后
把妖魔当成菩萨拜	善恶不分；害人又害已
把珍珠当泥丸	真不识货
把状元关到门背后	埋没人才
靶场上的老黄忠	百发百中
靶场上练瞄准	睁只眼闭只眼
霸王别姬	无可奈何
霸王请客	吃也得吃，不吃也得吃
霸五项羽	不町一世
白鼻子（戏剧中的丑角）演戏	陪衬
白玻璃瓶装清水	看透了
白布进染缸	洗不清
白布做棉袄	反正都是理（里）
白菜熬豆腐	谁也不沾谁的光（比喻谁也占不到谁的好处。）
白菜长心	老了
白菜烩豆腐	谁也不沾谁的光
白菜叶子炒大葱	亲（青）上加亲（青）
白痴的葫芦	傻瓜一个
白骨精扮新娘	娇里妖气
白骨精唱歌	怪腔怪调
白骨精打跟头	鬼把
白骨精的饭食	碰也不要碰
白骨精给唐僧送饭	假仁假义；没安好心
白骨精化美女	人面鬼心
白骨精见了孙悟空	现原形了
白骨精开口	不讲人话
白骨精骗唐僧	一计不成又生一计
白骨精说人话	妖言惑众
白骨精想吃唐僧肉	痴心妄想
白骨精遇上孙悟空	原形毕露
白骨精照镜子	里外不是人
白骨精装新娘	妖里妖气
白鹤站在鸡群里	突出
白灰店里买眼药	找错了门（比喻门路不对。）
白蜡树上结桂花	根子不正
白脸蛋上打粉	可有可无
白脸奸臣出场	恶相
白露过后的庄稼	
白萝卜扎刀子	不出血的东西（①比喻不肯多出钱。②比喻不爽快。）
白毛乌鸦	与众不同
白米换糠	有福不会享
白娘娘斗法海	精打光
白娘娘喝了雄黄酒	现了原形
白娘子斗法海	精打-光
白娘子喝了雄黄酒	现了原形
白娘子救许仙	尽心尽力
白娘子突断桥	想起旧情来
白娘子压在雷锋塔下	总有人搭救
白娘子遇许仙	千里姻缘一线牵
白日做梦	胡思乱想
白水锅里揭豆腐皮	办不到
白水煮冬瓜	没啥滋味
白水煮豆腐	淡而无味
白素贞不舍许仙	恩爱难分
白素贞哭断桥	想起旧情
白糖拌苦瓜	又苦又甜（比喻矛盾的心理状态或复杂的感情。）
白糖拌蜜糖	甜上加甜
白天打灯笼	白搭
白天照电筒	多此一举
白眼狼戴草帽	变不了人；假充善人（比喻心肠歹毒的坏人伪装成好人，进行欺骗。）
白眼狼戴眼镜	冒充好了
白杨树叶子	两面光
白衣秀士当寨主	容不得人
白蚁蛀观音	自身难保
白蚁钻过的料	坏透了
白纸黑字	黑白分明
白纸上画黑道	抹不掉；不能容人
白纸上写黑字	赖不掉；变不了；明摆着
百尺竿头挂剪刀	高才（裁）
百合地里栽甘蔗	苦根甜苗
百家姓不念第一个字	开口就是钱（比喻眼睛里只有钱。）
百家姓读掉头个字	开口就说钱；钱字当头
百家姓里的老四	说的是理（李）
百家姓上少了第二姓	缺钱
百家姓少了第二姓	没钱
百斤担子加铁砣	重任在肩
百里草原安家	孤孤单单
百里长的公路不用拐弯	太直了
百里舜（春秋时虞国大夫，后成为秦国左相）认妻	位高不忘旧情
百灵鸟碰到鹦鹉	会唱的遇上会说的（比喻各有特长。）
百灵戏牡丹	鸟语花香
百灵遇鹦鹉	会唱的碰到会说的
百米短跑	有始有终
百年的大树	根深蒂固
百年的瓜子千年的树	根深蒂固
百年的歪脖树	定型了
百年鸟龟下臭卵	老坏蛋
百年松树，五月芭蕉	粗枝大叶
百年松做柴烧	大材小用；屈才
百鸟展翅	各显其能
百岁老人过生日	难得有一回
百岁老人学跳舞	人老心不老
百岁老人做大寿	四世同堂
百岁养儿子	得之（子）不易
百万雄师下江南	兴师动众
百万雄狮过大江	势不可当
百丈高竿挂红灯	外面看见里面红（比喻表面上有错，实际上不行。）
百只麻雀炒碟菜	尽是嘴
柏木椽子（chuan zi	宁折不弯
柏油烫猪头	连根拔
摆渡不成翻了舟	两头误
败家子回头	金不换
拜罢天地去讨饭	没过一天好日子
拜佛走进吕祖（吕洞宾）庙	走错了门
拜年不磕头	干什么来了
拜年的话	好听
拜年的见了面	你好我也好
拜堂的夫妻	谢天谢地
拜堂听见乌鸦叫	倒霉透了；扫兴
扳不倒（不倒翁）掉到水缸里	摇摇摆摆
扳不倒盖被子	人小辈（被）大
扳不倒照镜子	里外不是人
扳倒大树掏老鸽	拣有把握的干
扳倒大树掏老鸹	拣有把握的干
扳倒大瓮掏小米	摸到底了
扳倒碓窝（dui wo石臼）吓婆婆	泼妇
扳倒葫芦洒了油	一不做，二不休
扳倒礁窝，吓跑婆婆	泼妇
扳倒树掏老鸹	稳逮
扳手紧螺帽	丝丝入扣
扳着指头算账	有数
班门弄斧	自不量力
班头（衙门里缉捕犯人的差役）打他爹	公事公办
斑鸠打架	卖弄风流
斑马的脑袋	头头是道
搬家丢了老婆	粗心极了
搬起石磙砸碾盘	实（石）打实（石）
搬起石头砸自己的脚	自作自受；自找罪受自讨苦吃
搬石头打脑壳（脑袋）	自讨苦吃过不去
搬石头上山	费力不讨好；又蠢又笨
搬梯子上大	没门；难上难；瞎张罗
搬竹竿进胡同	直来直去
搬着车轱辘（gu lu车轮）上山	硬干
搬着梯子上天	没门
板凳倒地	四脚朝天
板凳倒立	四脚朝天
板凳爬上墙	怪事一
板凳上打麻将	抓不开
板凳上放鸡蛋	不可靠；好险；危险
板凳上搁蒺藜（ji li一年生草本植物。尖刺）	坐不住
板凳上搁窝窝头	有板有眼
板凳上睡觉	翻不了身；难翻身，往宽绰想好梦不长
板门上贴门神	一个向东，一个向西
板上钉钉子	稳扎稳打
半边猪头	独眼
半道上捡个喇叭	有吹的了
半道上遇亲人	喜相逢
半吊子的一半	二百五
半个铜钱	不成方圆
半个月绣不出一朵花	真（针）差
半截梭子织布	独来独往
半斤对八两（旧制八两为半斤）	一码事
半斤换八两	谁也不沾谁的光；谁也不吃亏
半空的云彩	变化多端
半空中荡秋千	不落实
半空中的火把	高明
半空中的气球	上不着天，上不着地；悬着哩
半空中点灯	高明
半空中吊帐子	不着实地
半空中放风筝	总有牵线人
半空中挂锅铲	吵（炒）翻了天
半空中挂剪刃	高才（栽）
半空中挂口袋	装疯（风）
半空中抹糨子（jiang zi）糨糊）	胡（糊）；
半空中骑马	腾云驾雾
半拉瓜子	不算个人（仁）；你算什么人
半篮子喜鹊	叽叽喳喳
半两人说千斤语	好大的口气
半路上碰见劫道的	凶多吉少
半路上出家	从头学起
半路上丢算盘	失算了
半路上留客人	嘴上热情
半路上留客	嘴上热情；嘴上热闹
半路上杀出个程咬金	突如其来：措手不及
半路上杀出个杨排风	好厉害的丫头
半路天小差	有始无终
半瓶于醋	晃荡得很
半身子躺在棺材里	等着死（比喻不能再为人民做贡献了。）
半天打不出喷嚏来	难受
半天云里踩钢丝	提心吊胆
半天云里长满草	破天荒
半天云里唱歌	调子太高
半天云里吃喝	空喊
半天云里吹唢呐	想（响）得高
半天云里打灯笼	高明
半天云里打电话	空谈
半天云里打麻雀	空对空
半天云里打算盘	算得高
半天云里打铜锣	四方闻名（鸣）；响当当
半天云里点灯	高招（照）
半天云里翻跟头	不着实地
半天云里翻筋头	终究要落地（比喻早晚要跌跟头。）
半天云里翻账簿	算得高
半天云里放屁	臭气熏天
半天云里挂锅铲	吵（炒）翻（飞）了天
半天云里挂剪子	高才
半天云里挂口袋	装疯（风）
半天云里喊口号	呼声很高
半天云里拉家常	空谈
半天云里聊天	高谈阔论
半天云里扭身歌	空欢喜（比喻白白地高兴一场，并没有达到目的。）
半天云里扭秧歌	空欢喜；空喜
半天云里拍巴掌	空想（响）
半天云里抛棉花	肯定落空
半天云里跑马	露马脚
半天云里骑仙鹤	远走高飞
半天云里响炸雷	惊天动地
半天云里写文章	空话连
半天云里演杂技	艺高人胆大
半天云里找对象	要求太高
半天云里作演说	高论
半天云里做演说	高论
半天云中拍巴掌	高手
半天抓云	一句空话
半响打不出喷嚏来	干难受
半夜拔河	暗中使劲
半夜不见枪头子	攮（nang用力刺）到贼肚里
半夜吃甘庶	不知头尾
半夜吃黄瓜	不知头尾（比喻不知事情的经过或底细。）
半夜吃黄连	暗中叫苦
半夜出门做生意	赚黑钱
半夜打雷心不惊	问心无愧
半夜弹琴	暗中作乐
半夜过独木桥	步步小心
半夜鸡叫	乱了时辰
半夜里的铺盖（被子）	没人理
半夜里和面	瞎鼓捣
半夜里抡大斧	瞎砍一通
半夜里梦见做皇帝	快活一时是一时（比喻无止境的追求欢乐或比喻美梦不长，空喜欢了一场。）
半夜里摸帽子	为时过早；太早了
半夜里撒呓挣（sa yi zhenQ熟睡时说话或动作	迷迷糊糊
半夜里摘茄子	不分老嫩
半夜里捉虱子	瞎摸；摸不着
半夜聊天	瞎说
半夜闹王殿	暗中搞鬼
半夜爬山	不知高低
半夜起来骂阎王	等死等不到天亮
半夜敲钟	一鸣惊人
半夜三更放鞭炮	一鸣惊人
半夜三更亡茅房（厕所）	迫不得已
半夜下馆子（饭馆）	吃闭门羹
半夜做恶梦	虚惊一场
半夜做买卖	暗中交易
半夜做梦娶新娘	想得倒美
半衣敲钟	一鸣惊人
半衣捅鸡窝	暗中捣蛋
拌桶（田里脱谷粒用的方形大木桶）包豆腐	大方
绑着腿的青蛙	跳不了啦
膀子折断了往袖里塞	干吃哑巴亏
蚌壳里取珍珠	图财害命；谋财害命
蚌里藏珍珠	好的在里面
棒糙上天	总有一头落地
棒槌（洗衣时用以捶打的木棍）吹火	一窍不通
棒槌吹火	一窍不通
棒槌打缸	四分五裂
棒槌弹棉花	乱谈（弹）
棒槌当针	粗细不分
棒槌锻磨	胡凿
棒槌缝衣服	当真（针）
棒槌拉胡琴	粗中有细；不是正经家
棒槌里插针	粗中有细
棒槌敲鼓	大干一场
棒槌敲竹筒	空想（响）
棒打鸭子	呱呱叫
棒打鸳鸯	两分离；难分开
棒相当针	粗细不分（比喻没深没浅，分不出好坏。）
棒子面（玉米粉）抻（ch6n扯）面条	要的就是这个劲儿
棒子面煮葫芦	胡胡涂涂
棒子面煮鸡子儿（鸡蛋）	糊涂蛋
棒子面做蛋糕	不是正经材料
磅秤上放粒芝麻	无足轻重
包办婚姻	不由自主
包单（被单）布洗脸	大方
包单布洗脸	大方
包工头监工	动口不动手
包公的上方宝剑	先斩后奏
包公的衙门	好进难出
包公的铡刀	不认人
包公断案	铁面无私
包公放粮	为穷人着想
包公审案子	铁面尤私；六亲不认
包公升堂	尽管直说
包公铡陈世美	公事公办；大快人心
包公铡驸马	刚正不阿；公事公办
包公铡皇亲	法不容人；六亲不认
包公斩包勉	正人先正己
包脚布当孝帽	一步（布）登天；能到顶了
包脚布裹金条	内中有宝；外贱内贵
包脚布满天飞	打的什么旗号
包脚布上飞机	一步（布）登天
包脚布围嘴	臭了一圈
包脚布做围脖	臭一圈儿
包老爷（包公）办案	明察秋毫
包老爷怒铡陈世美	一刀两断
包老爷升堂	一呼百应；前呼后拥
包龙图断案	认理不认亲：六亲不认
包米面做元宵	捏不到一块儿
包子吃到豆沙边	尝到甜头
包子出了糖	露了馅儿（比喻不愿意让人知道的事暴露出来了。）
包子馒头做一笼	大家都争气
包子没馅	蛮（馒）头
包子张嘴	露馅
苞谷秆里的虫	专（钻）心
苞谷秸喂牲口	天生的粗料
苞谷面做元宵	捏不拢
龅牙齿（bao ya chi）牙齿穿出于嘴唇外的人啃西瓜	条条是道；道道多
雹打的高梁秆	光棍一条
宝剑出鞘	锋芒毕露
宝玉和湘云哭贾母	各有各的眼泪
宝玉湘云哭贾母	各有各的伤心处
饱带干粮晴带伞	有备无患
保姆做嫁妆	替别人欢喜
保险柜里安家	图的是安全
保险柜里安雷管	暗藏杀机
报晓的公鸡	叫得早
抱干柴救烈火	越帮越忙
抱黄连敲门	苦到家了
抱鸡婆打摆子	窝里战（颤）
抱鸡婆带娃娃	只管自家一窝
抱木偶打狗	把你不当人
抱菩萨洗澡	淘神
抱窝鸡带崽	可忙啦
抱元宝跳井	爱财舍命；舍命不舍财
抱在怀里的西瓜	十拿九稳（比喻办事非常准确或有把握。）
抱着擀面杖当笙吹	一窍不通
抱着孩子拜天地	双喜临门
抱着黄连做生意	苦心经营
抱着机器人亲嘴	你有情他无意
抱着金砖跳海	人财两空；爱财如命
抱着蜡烛取暖	无济于事
抱着老虎喊救命	自找死
抱着木炭亲嘴	触一鼻子灰
抱着琵琶进磨坊	对牛弹琴
抱着屁股上楼	自己抬自己
抱着菩萨亲嘴	一头热乎
抱着钱罐子打吨	财迷
抱着钱匣子睡觉	财迷心窍
抱着石头跳深渊	死不回头
抱着铁耙子亲嘴	自找钉子碰
抱着元宝跳井	舍命不舍财
抱着枕头跳舞	自得其乐
抱着枕头做好梦	空喜一场
豹蝉唱歌	有声有色
豹子借猪狗借骨	有去无回
豹子进山	浑身是胆
暴风雨中的航船	顶风破浪
暴雨前的闪电	人发雷霆
爆炒鹅卵石	不进油盐；油盐不进
爆米花沏茶	泡汤了
爆竹的脾气	一点就炸
杯水救燎原	无济于事；微不足道
北冰洋的梅子	寒酸
北冰洋的夜晚	冷静
北冰洋上聊天	全是冷言冷语
北极的冰川	顽固不化
北极的另一端	难（南）极
北极熊打呵欠	尽吹冷风
北面开窗	不怕冷风
背鼎锅跳加官（旧时戏曲开场或演出中，遇显贵到场时，加演的舞蹈节目）	费力不讨好
背鼓进祠堂	一副挨打的相
背鼓进庙	找锤
背后藏茄子	有外心
背后拉弓	暗箭伤人
背后抹胡琴	拉不着
背后施一礼	没人领情
背后捅刀子	暗伤人
背后作揖	反礼
背靠背睡觉	体贴人
背靠背走路	各奔东西
背靠悬崖	没退路了
背门板上街	好大的牌子
背菩萨下河	淘神
背起棺材过黄河	连后路都准备好了
背人偷酒吃	冷暖自家知
背上被刺扎	不能自拔
背石头上山	自找麻烦；硬吃亏
背时（倒霉）的媒婆	两头挨骂
背死人过河	吃力不讨好；费劲不落好
背媳妇烧香	吃力不讨好
背心藏臭虫	久仰（痒）
背心穿在衬衫外	乱套了
背油桶救火	惹火烧身
背着醋罐子讨饭	穷酸
背着粪筐上银行	臭钱
背着粪篓满街窜	找死（屎）
背着甘蔗上楼梯	步步高，节节甜
背着棺材上战场	往最坏处想；豁上命
背着哈哈镜走路	不怕后人见笑
背着孩子爬山	要上都上
背着脚扣上梯子	多此一举
背着喇叭坐飞机	吹上天了（比喻过份的说大话。）
背着灵牌上火线	拼啦
背着马桶出差	走到哪儿臭到哪儿
背着棉花过河	负担越来越重
背着棉絮过河	越背越重
背着牛头不认账	死赖
背着婆娘看戏	丢人又受累
背着人作揖	各尽其心
背着石磨上山	费力不讨好
背着石头上泰山	受累不讨好
背着水讨饭	装穷
背着唢呐坐飞机	吹上天了
背着娃娃推磨	添人不添劲
被打败的公鸡	垂头丧气
被单补袜子	大材小用
被单里眨眼睛	自欺欺人；自己哄自己
被单蒙桌子	作为（包围）很大
被单作尿布	太大方
被封住了嘴巴	哼不得声
被糊涂油蒙了心	一点不清醒
被埋没的陶俑	难出头
被面补抹子	大材小用
被面上刺绣	锦上添花
被迫打的老鼠	见洞就钻
被窝里不见了针	不是婆婆就是孙
被窝里放屁	独吞；能文（闻）能武（捂）
被窝里划拳	没掺外手
被窝里挤眉弄眼	自己糊弄自己
被窝里磨牙	怀恨在心
被窝里抹眼泪	独自悲伤
被窝里伸手	摸清底细
被窝里耍拳	有劲使不上
被窝里喂虎	害人又害己
被窝里捉跳蚤	瞎抓
被追打的老鼠	见洞就钻
被子里边烂	表面好
笨狗撵（nian 追赶）兔子	不沾边；挨不上
笨姑娘纳鞋底	坑坑洼洼
笨牛吃麻雀	不好捉弄
笨婆娘打架	拉拉扯扯
笨媳妇纳的袜底儿	坑坑洼洼
笨贼偷法官	自投罗网
笨贼偷石臼	吃力不讨好；费力不讨好
笨猪拱蒺藜（ji li一年生革本植物。果皮有尖刺）	自找苦吃
崩鼻子戴眼镜	没着落
崩了群的马	四处逃散
崩子（beng zi小形硬币）当眼镜	看不透
逼公鸡下蛋	故意刁难；办不到
逼人跳海	害人不浅
逼着牯牛（公牛）生子	强人所难
鼻尖抹黄连	苦在眼前；眼前苦
鼻尖上的黑痣	近在眼前
鼻尖上着火	迫在眉睫
鼻孔里灌米汤	够戗（够受的）
鼻孔里氏瘤子	气不顺
鼻窟窿看天	有眼无珠
鼻梁骨上摆摊子	眼界要放宽
鼻梁碰着锅底灰	触霉头（倒霉）
鼻梁上：套绳索	让人牵着鼻子走
鼻梁上放菜刀	好险
鼻梁上挂钥匙	开口
鼻梁上推小车	走投（头）无路
鼻粱骨上摆摊子	眼界要放宽（比喻放天视野）
鼻涕沉到嘴里	各人吃各人的
鼻涕流到嘴里	吃亏沾光没外人
鼻头搽白粉	一副奸相
鼻头上挂粪桶	不知香臭
鼻头上抹鸡屎	脸上尴尬（gan ga）
鼻头上耍木偶	面上人
鼻子里插葱	装相（象）
鼻子里插大葱	装象（相）
鼻子两旁画巴毛	不要脸
鼻子上安雷管	祸在眼前；急在眼前
鼻子上搽粉	一副奸相（比喻奸邪馅媚的人）
鼻子上戴花	不是个地方
鼻子上挂秤砣	抬不起头来（比喻受压制的人或事物得不到伸展。）
鼻子上挂灯笼	明眼人
鼻子上挂钉锤	可（掴）耻（齿）
鼻子上挂粪桶	不知香臭
鼻子上挂磨盘	抬不起头来
鼻子上挂肉	油嘴
鼻子上冒烟	急在眼前
鼻子上抹蜜糖	干馋捞不着
鼻子上推小车	走投（头）无路
鼻子生疮	眼前就是毛病
鼻子眼里生豆芽	怪事一桩：怪事
比着被子伸腿	量力而行
比着葫芦画瓢	走不了样
笔端的大马路	正直公道
笔杆子吹火	小气
笔杆子吞进肚	胸有成竹
笔管里打瞳睡	细人
笔筒吹火	小气（①比喻吝啬。②指气量小，③形容人的举止、行动等。）
笔筒里看天	眼光狭窄
闭门造车	自作聪明
闭日养神	悠然自得
闭眼吃虱子	眼不见为净
闭眼撕皇历	瞎扯
闭眼撞南墙	碰得头破血流
闭着眼睛哼曲子	心里有谱
闭着眼睛进山洞	难免碰壁
闭着眼睛卖布	瞎扯；胡扯
闭着眼睛撒网	瞎张罗
闭着眼睛下围棋	黑白不分；混淆黑白
闭着眼睛训话	瞎说
闭着眼睛踵河	听天由命
箅子（bi zi有空隙而能起间隔作用的器具。）上取窝头	十拿九稳
壁虎捕虫	不动声色
壁虎捕食	出其不意
壁虎掀门帘	露一小手
壁画上的樱桃	中看不中吃
壁角里使攫头（jue tou刨土用的农具）	挖墙脚（角）
壁上的春牛	离（犁）不得；跟（耕）不得
壁上挂帘子	不像话（画）
边吃苞米边拉呱儿（闹谈）	开黄腔
边放鞭炮边打枪	真真假假
编编匠（善于哄骗的人）的嘴	说得好听
编幅看太阳	瞎了眼
蝙蝠的眼睛	目光短浅
鞭打千里驹	快马加鞭
鞭杆当笛吹	没心眼
鞭杆做大梁	不是正经东西
鞭炮店失火	自己恭维自己
鞭子抽耳朵	打听打听；打听
鞭子抽蚂蚁	专拣小的欺
扁担插进桥眼里	担不起
扁担吹火	一窍不通
扁担上搁鸡蛋	好险
扁担上睡觉	难翻身；翻不了身
扁担挑柴火	心（薪）挂两头
扁担挑灯笼	两头明
扁担挑水	心挂两头
扁担无钩	两头滑
扁担无扎	两头滑脱；两头滑
扁担做桨用	划不来
扁担做桅杆	担风险
扁鹊开处方	于到病除
扁食（饺子）馅里搀砒霜（pi shuang砷的氧化物。剧毒）	心里毒
扁相捣鸡笼	鸡飞蛋打
扁嘴子（鸭子）过河	摸不着底
便壶没鼻	不好捉摸
便宜买回的处理品	贱货
变戏法的本领	全凭手快
变戏法的功夫	于疾眼快
变戏法的亮手帕	不藏不掖
变戏法的拿块布	掩掩盖盖
变形的钢板	难校正
变质的鸡蛋	臭在里面
婊子立牌坊	假正经
婊子骂娼	一路货色
婊子送客	假仁假义
裱糊匠开糟房（酿酒作坊）	酒少话（画）多
裱糊匠止天	胡（糊）云
蹩脚木匠的活路（活儿）	东一句（锯），西一句（锯）
瘪了的唢呐	看你怎么吹
瘪芝麻榨油	油水不大
瘪嘴吹箫	走风漏气
镔铁做铧口	离（梨）不得
殡仪馆里的棺材	装人
冰雹砸荷叶	不堪一击；落花流水
冰雹砸了棉花棵子	尽光棍
冰河上架屋	白搭
冰窖着火	没见过
冰库里点蜡	洞（冻）房花烛
冰块掉进醋缸里	寒酸
冰凌当拐杖	靠不住；不可靠
冰凌调豆腐	难办（拌）
冰凌挂胸n	凉透了心
冰凌上跑马	站不住脚
冰面上盖房子	不牢靠
冰山上画画	好景不长
冰滩上的鱼	由（游）不得了
冰糖调黄瓜	千干脆脆；干脆
冰糖葫芦	一串一串的
冰糖煮黄连	同甘共苦；苦中有甜
冰天雪地发牢骚	冷言冷语
兵来将挡，水来土掩	一物降一物；各有办法
并列第一	不相上下
病床上摘牡丹	临死还贪花
病好打太医（医生）	恩将仇报；以怨报德
病好遇良医	晚了，迟了
病人断了气	要（药）来也没用
病人膏盲	不可救药；没治了
病人遭雷打	天灾人祸
病人装进棺材	不可救药
病重不吃药	等死
拨着头发找疤瘌	吹毛求疵
玻璃板上涂蜡	又光又滑
玻璃棒槌	中看不中用
玻璃杯沏茶	看到底
玻璃窗里看戏	一眼看穿；一眼看透
玻璃灯笼	里外明
玻璃灯罩	吹出来的
玻璃店搬家	少砸不了
玻璃肚皮	看透心肝
玻璃缸里的金鱼	翻不了大浪
玻璃缸里养鱼	大不了
玻璃耗子琉璃猫，铁铸公鸡铜羊羔	毛不拔
玻璃镜照着清泉水	嘴里不说他心里都明白
玻璃筷子夹凉粉	光对光
玻璃瓶里插蜡烛	肚里明
玻璃瓶里装开水	三分钟的热劲
玻璃瓶里装王八	原（圆）形毕露
玻璃铺的家当	不堪一击
玻璃菩萨	神明
玻璃球上拴麻线	难缠
玻璃上放花盆	明摆着
玻璃袜子玻璃鞋	名角（明脚）
玻璃罩里的苍蝇	看到光明无出路；处处碰壁
玻璃做鼓	经不起敲打
剥葱捣蒜	干的小事
剥开墨鱼皮了肚	一副黑心肠
剥开皮肉种红豆	入骨相思
剥了皮的蛤蟆	临死还要跳三跳
剥皮的狗头	太露骨
剥皮的青藤	一丝不挂
剥皮的树	不长
剥皮的猪头	太露骨
脖子里套绳子	想死
脖子上安轴承	脑袋灵活得很
脖子上插电扇	尽走上风
脖子上割瘿袋（ying dai生长在脖子上的囊状瘤。民间有除瘿会危及生命的说法）	杀人的勾当；耍人命
脖子上挂镰刀	好险
脖子上磨刀	危险到顶
脖子上围裹脚布	臭了一圈儿
脖子上抓笊篱（zhao li捞取东西的用具。用金属丝、竹蔑戍柳条等编成。有长柄）	劳（捞）心
脖子送到铡刀下	迭死；自己找死
菠菜煮豆腐	一清（青）二臼
博物馆的陈列品	老古董
薄冰上迈步	胆战心惊；战战兢兢
薄刀切豆腐	两面光
薄情郎休妻	另有新欢
跛脚穿花鞋	边走边瞧
跛脚佬打猎	坐着喊
跛脚马碰到瞎眼骡	难兄难弟
跛脚马上阵	没有好下场
跛脚青蛙碰着瞎田鸡	难兄碰到难弟
跛子踩高跷	早晚有他的好看
跛子唱戏文	下不了台
跛子赶老婆	越赶越远
跛子划船	以歪就歪
跛子爬楼梯	步步难
跛子爬山	一步三分险；步步有险
跛子骑瞎马	各有所长
跛子走路	左右摇摆
簸箕比天大，叫花子（乞丐）比神仙	无法沾边
簸箕里的蚂蚁	条条是道
补锅匠的脊梁	背黑锅
补锅匠揽瓷器活	充内行
补过的碗盏	留下痕迹
补了又补的破轮胎	到处泄气
不挨皮鞭挨砖头	吃硬不吃软
不拨灯不添油	省心（芯）
不长毛的家雀	飞不了
不吃桑叶的老蚕	尽是私（丝）
不吃羊肉羊臆臭	自背臭名
不出鸡的鸡子儿（鸡蛋）	坏蛋
不搭棚的葡萄	没有架子；不摆架子
不大不小的老鼠	最刁
不倒翁沏茶	没水平
不倒翁骑兔子	没个老实劲儿
不倒翁坐车	左右摇摆；东倒西歪
不到黄河心不死	顽固不化
不犯王法坐大牢	冤枉，
不放酱油浇猪爪	白提（蹄）
不放酱油烧猪蹄	白提（蹄）
不共戴天的敌人	有你无我
不会喝酒伴醉客	舍命陪君子
不见棺材不落泪	死心眼儿
不叫的黄蜂	暗伤人
不叫喊的狗	暗里伤人
不敬东家（受人雇用或聘请的人称他的主人）散伙计	认错了主
不开花的玫瑰	净刺儿
不碰南墙不回头	顽固到底
不识字的人看布告	一纸都是墨
不是鱼死，就是网破	有你无我
不熟的葡萄	酸得很
不听曲子听评书	说的比唱的好听
不栽果树吃桃子	坐享其成
不炸嘴的石榴	满肚子花花点子
布袋里买猫	不知底细
布袋里塞稻秆	草包
布袋里装牛角	内中有弯
布袋装水	一场空
布机上的棉线	干头万绪
布机上的梭子	直来直去；去了又来
布娃娃的眼睛	有眼无珠
擦胭粉进棺材	死要面子（比喻非常好脸。）
才出壳的鸡子	嫩的很
才出窝的麻雀	翅膀不硬
才过门的媳妇见公婆	唯唯诺诺
才揭盖的蒸笼	热气腾腾
才输了当头炮	慌什么哩
才脱了阎王，又撞着小鬼	祸不单行
才学理发就碰上大胡子	难题（剃）
才捉到的鲤鱼	活蹦乱跳
才子佳人结鸳鸯	好事成双
才子配佳人	恰好一对
财神爷打官司	有钱就有理
财神爷戴乌纱帽	钱也有，权也有
财神爷发慈悲	有的是钱
财神爷翻脸	不认账
财神爷放帐	无利可图（比喻谋取不到好处。）
财神爷叫门	好事临头；有钱花了;天大的好事
财神爷敲门	福从天降；天大的好事
财神爷休妻（息）	不为穷人着想（比喻不可怜穷人。）
财神爷要饭	装穷
财神爷招手	来福了（比喻来了福气。）
财神爷着烂衫	人不可貌相
财主杀妻	为富不仁
裁布不用剪子	胡扯
裁缝不带尺	存心不良（量）
裁缝打狗	有尺寸（比喻办事有分寸。）
裁缝打架	真（针）干
裁缝的尺子	量人不量己；量体裁衣
裁缝的家当	真正（针挣）的
裁缝丢了剪子	只有吃（尺）了
裁缝干活	忘不了吃（尺）
裁缝撂（liao抛弃；扔）剪刀	不睬（裁）
裁缝铺扯筋（有纠纷闹矛盾）	争长论短
裁缝铺的衣服	一套一套的
裁缝师傅戴戒指	顶真（针）
裁缝师傅的手艺	量体裁衣
裁缝师傅买田	千真（针）万真（针）
裁缝师傅手中忙	穿针引线
裁缝绣娘	各干一行
裁缝智能了剪子	只有尺（吃）了
裁缝做嫁衣	替别人欢喜
裁缝做衣不用尺	自有分寸
彩虹和白云谈情	一吹就散
踩凳子够月亮	差远了
踩高跷上高墙	胆战心惊
踩虎尾，踏春冰	冒险
踩梯子摘星星	差天远
踩着鼻子上脸	欺人太甚
踩着脖子敲脑壳	太欺负人了
踩着地图走路	一步十万八千里
踩着高跷过独木桥	艺高胆大
踩着高跷演戏	半截不是人
踩着肩膀撤尿	成心糟踏人
踩着肩头往头上拉屎	硬欺负人（比喻欺人太甚）
踩着麻绳当蛇	大惊小怪
踩着石头过河	脚踏实地
踩着西瓜打球	能推就推，能滑就滑
踩着银桥上金桥	越走越亮堂
菜刀切藕	片片有眼
菜刀剃头	太悬乎
菜瓜打锣	一锤子买卖
菜馆里的揩台布	酸甜苦辣样样尝过
菜篮子装泥鳅	爬的爬，溜的溜
菜园里长狗尿苔（鬼笔。一种有毒的真菌）	不是好苗头
菜园里的苦瓜	越老心越红
菜园里的辣椒	越高越厉害
菜园里的垄沟	四通八达
菜园里的辘轳（lu lu）	任人摆布
菜籽里的黄豆	数它大
参谋皱眉头	一筹（愁）莫展
参天大树	高不可攀
餐桌上搁痰盂	不是正经家伙
蚕宝宝吃桑叶	胃口越来越大
蚕宝宝牵蜘蛛	私（丝）连私（丝）
蚕宝宝做茧	自己捆自己
蚕豆开花	黑了心
蚕爬扫帚	净找茬（杈）儿
蚕子变蛾子	要飞了
灿烂的朝霞	红红火火
苍蝇不咬人	恶心
苍蝇采花	装疯（蜂）
苍蝇吹喇叭	自不量力；不自量
苍蝇的翅膀	扇不起多大风浪
苍蝇的世界观	哪里臭往哪里钻（比喻参与干些肮脏事。）
苍蝇掉进饭碗里	恶心
苍蝇掉在酱缸里	糊里糊涂
苍蝇叮大粪	臭味相投
苍蝇叮鸡蛋	无孔不入
苍蝇叮菩萨	没有人味
苍蝇放屁	吓谁哩（比喻一点威力没有。）
苍蝇飞进花园里	装疯（蜂）
苍蝇飞进牛眼里	找累（泪）吃
苍蝇给牛抓痒痒	无济于事
苍蝇害眼病	早晚要碰壁
苍蝇会蜘蛛	自投罗网
苍蝇见粪堆	盯（叮）住不放
苍蝇进虎门	不够塞牙缝
苍蝇尥蹶子（liao jue zi）	小踢蹬
苍蝇碰上蜘蛛网	脱不了身
苍蝇围着厕所转	臭味相投
苍蝇洗脸	假干净
苍蝇找地方下蛆	见缝就钻
苍蝇找屎克螂做亲	臭味相投
苍蝇撞上瘫蛤蟆	自送一口肉
苍蝇钻到瓶瓶里	处处碰壁
苍蝇钻茅房（厕所）	沾腥惹臭
苍蝇嘴巴狗鼻子	真灵；灵的很
藏民穿皮袄	露一手，留一手
操场上捉迷藏	无处藏身
操练的士兵	步调一致
曹操败走华容道	不出所料
曹操背时遇蒋干，胡豆（蚕豆）背时遇稀饭	倒霉透了
曹操战宛城	大败而逃
曹操吃鸡肋	食之无味，弃之可惜
曹操打徐州	报仇心切
曹操的人马	多多益善
曹操割须	以己律人
曹操杀蔡瑁	操之过急
曹操杀华佗	讳疾忌医
曹操杀吕布	悔之莫及
曹操下江南	来得凶，败得惨
曹操用计	又奸又滑
曹操遇蒋干	误大事
曹操遇庞统	中了连环计
曹操张飞打哑谜	你猜你的，我猜我的
曹操诸葛亮	脾气不一样（比喻人不同，性格也不相同。）
曹操作事	干干净净
曹操做事	疑心重
草把子作灯	粗心
草包竖大汉	能吃不能干
草船借箭	满载而归；巧用天时
草袋换布袋	一代（袋）强似一代（袋）
草地上的蘑菇	单根独苗
草地上捉鸭子	干扑
草堆里蹦出个兔子	你也算个保镖
草房上安兽头	配不上
草驴（母驴）卖了买叫驴（公驴）	胡捣腾
草帽当钹（bo打击乐器）	没有音
草帽当锅盖	乱扣帽子
草帽当锣打	响（想）不起来
草帽烂边	顶好
草帽烂了边	顶好；没言（沿）
草帽破了顶	露头
草帽子端水	一场空
草坪里丢针	没处寻
草人的胸腔	无心
草上的露水	难长久
草上露水瓦上霜	见不得阳光
草绳子拔河	经不住拉
草窝里扒出个状元郎	埋没人才
草鞋脱襻（pan）	甩了
草原上的百灵鸟	嘴巧
草原上的疯骆驼	见人就撵（nian追赶）
草原上的狍子	三五成群
草原上的天气	变化多端
草原上放牧	漫无边际
厕所顶上开窗户	臭气冲天
厕所里吃甘蔗	臭嚼
厕所里吃烧饼	口难开；不好开口
厕所里吃香瓜	不对味儿
厕所里搭棚	臭架子
厕所里的蛆	讨人嫌
厕所里的消息	丑闻
厕所里放芝麻	香臭不分
厕所里挂绣球	配不上
厕所里洒香水	香臭难分
厕所里耍笔杆	丑（臭）闻（文）
厕所里响唢呐	臭吹
厕所里寻灶王	找错了地方
厕所里照镜子	臭美（比喻做事太过分，使人厌恶和憎恨。）
厕所门口挂绣球	臭美
插根筷子当旗杆	竖不起来
茶杯掉在地上	净蹦（崩）词（瓷）
茶杯盖上放鸡蛋	靠不住
茶杯里放块糖	寿命不长
茶馆搬家	另起炉灶
茶馆的火剪	倒霉（煤）
茶馆里的买卖	滴水不漏
茶馆里开除的伙计	哪壶不开提哪壶
茶壶打掉把儿	只剩一张嘴了（比喻说话乖巧能说会道，没有真本领。）
茶壶掉了把儿	只有一张嘴
茶壶里洗澡	扑腾不开
茶壶里下元宵	只进不出（比喻非常吝啬，只许别人给他东西，他的东西从不外给。）
茶壶里煮冻梨	道（倒）出来也是酸货
茶壶里煮挂面	难捞
茶壶里煮馄饨	一肚子话（货）
茶壶里煮饺子	肚里有货倒不出；肚里有货
茶壶里煮元宵	满腹心事（食）
茶壶没肚儿	光剩嘴
茶壶有嘴难说话	热在里头
茶壶有嘴	说不出话
茶壶煮饺子	心中有数
茶壶装饺子	易进难出
茶铺搬家	另起炉灶（比喻放弃原来的，重新做起。）
茶铺里不要的伙计	哪一壶不开单提哪一壶
茶铺里招手	胡来
茶铺子里的水	滚开
茶食店失火	果然（燃）
搽粉进棺材	死要面子
搽粉上吊	死要脸
搽粉照镜子	自我欣赏
搽胭脂坐飞机	美上天了
岔道上分手	各走各的路
岔路上分手	各奔前程
拆城隍庙竖土地庙	因小失大
拆东墙补西墙	顾此失披
拆房逮耗子	得不偿失；大干一场
拆房卖瓦	只顾眼前
拆房子放风筝	只图风流不顾家
拆了东篱补西壁	穷凑合
拆了房子搭鸡棚	不值得
拆了茅房（厕所）盖楼房	底子臭
拆了鞋面做帽沿	顾头不顾脚
拆庙打泥胎	顺手杀一刀
拆庙散和尚	各奔东西
拆散的鸳鸯	难成双；成不了双；孤单得很
拆屋檐卖胖子（ban zi大块的劈柴）	穷思竭想
柴草人救火	自身难保
柴火棍搔痒	是把硬手
柴火上浇汽油	一点就着
柴油机抽水	吞吞吐吐
豺狗吃瘟鸡	弱肉强食
豺狼朝羊堆笑脸	阴险歹毒
豺狼恨猎人	死对头
豺狼披羊皮	充好人
豺狼请客	没安好心；居心不良
豺狼请兔子的客	没好事
豺狼遭火烧	焦头烂额
搀水的老白干	没冲劲儿
馋狗等骨头	急不可待
馋鬼抢生肉	贪多嚼不烂
馋猫挨着锅台转	别有用心
馋猫吃耗子	生吞活剥
馋猫见了腥味	沾上了
馋嘴巴走进药材店	自讨苦吃
铲不掉的锅巴	死硬
铲子切菜	不地道（抵刀）
长白山的大雪	满天飞
长白山的野人参	得之不易
长成的胡子，生就的相貌	更改不掉
长成的眉毛生就的痣	变不了；没法变
长城上的砖	未知经过多少风雨
长城上跑步	大有奔头
长翅膀的小鸟	欢跃欲飞；迟早要飞
长虫（蛇）吃棒槌	直脖啦
长虫吃高粱	顺杆（秆）爬
长虫吃蛤蟆	慢慢来
长虫吃鸡蛋	吞吞吐吐;疙疙瘩瘩
长虫戴草帽	细高挑（身材细长的人）
长虫斗仙鹤	绕脖子；
长虫过街	井（蟒）行
长虫过篱笆	见缝就钻；钻空子；
长虫爬进酒瓶里	进退两难
长虫爬进枪筒里	难回头
长疔疮的癞皮狗	走到哪臭到哪；走一路臭一路
长工吃犒劳	难得的好处
长工的岁月	难熬
长工害痨病	贫病交迫
长工家里殓死人	家破人亡
长江里漂木头	付（浮）之东流
长江流水	滔滔不绝
长颈鹿脖子仙鹤腿	各有所长
长颈鹿进马群	高出了头
长颈鹿进羊群	高出一大截；非常突出
长就的眉毛生就的相	变不了
长就的牛角	值（直）不得；直不了
长了三只手	爱偷
长了兔子腿	跑得快
长毛驴备银鞍	有点儿不配
长毛驴儿推磨	兜圈子
长毛驴驮不起金鞍子	不识抬举
长袍马褂瓜皮帽	老一套
长跑比赛	争分夺秒
长衫改夹袄	取长补短
长衫子改夹袄	取长补短
长丝瓜当扁担	不晓得软硬
长添灯草满添油	早作准备
长秃疮害脚气	两头不落一头
长尾巴蝎子	毒极了
长线放风筝	慢慢来
长一只耳朵的人	偏听偏信
长竹竿戳水道眼	一通到底
长竹竿进城	拐不过弯儿（比喻心里不痛快，想不开。）
长竹竿进巷道	直来直去
常胜将军	百战百胜
常胜将军回朝	凯旋归来
常走泥泞路	不怕栽跟头
嫦娥脸上长痣	美中不足
嫦娥跳舞	两袖清风
厂里开除的二愣子	要不得
唱歌离了谱	不入调
唱京戏拉单弦	变了调
唱驴皮影（皮影戏。因剧中人物剪影用驴皮做成而得名）	耍人哩；捉弄人
唱戏打边鼓	旁敲侧击
唱戏的拜天地	一会儿的夫妻
唱戏的穿龙袍	成不了皇帝
唱戏的吹胡子	假生气
唱戏的打板	一五一十
唱戏的点兵	名不副实
唱戏的喝彩	自吹自擂（比喻自我吹嘘。）
唱戏的胡子	活的；假的（比喻不真实。）
唱戏的教弟	幕后指点
唱戏的教徒弟	幕后指谱（比喻暗中出主意。）
唱戏的没主角	胡闹台
唱戏的抹两鬓	装样子
唱戏的念道白	自盲自语
唱戏的卸了装	原形毕露
唱戏的转圈圈	走过场（比喻敷衍场面，做给人看，表示有这么回事。）
唱戏没主角	胡闹台
抄着手过日子	等着饿死
钞票洗额头	见钱眼开
超载的火车	任重道远
朝天铳（chong一种旧式火器）走火	放空炮
朝天铳走火	放空泡
朝天放枪	空响（想）（比喻白费心思达不到目的）
朝天辣椒	又尖又辣；够呛
朝廷吃煎饼	均（君）摊
朝廷的闺女	金枝玉叶
朝廷的太监	后继无人
朝廷老爷拾大粪	有福不会享
朝廷说话	金口玉言
朝中无人莫做官	没靠山
朝种树，夜乘凉	不可能的事；没人见过
炒菜不放盐巴	乏味
炒菜的铲子	尝尽了酸甜苦辣
炒菜的勺子	尝尽了酸甜苦辣（比喻幸福、痛苦等种种滋味都尝到过）
炒菜放错了估料	不对味
炒胡豆（蚕豆）下酒	干干脆脆
炒韭菜放葱	白搭
炒韭菜搁葱	白搭
炒了的虾米	红人（仁）
炒了的虾仁	红透了（①比喻已经熟透了。②比喻受宠信的人。）
炒了一盘麻雀脑袋	多嘴多舌
炒了一盆麻雀脑袋	多嘴多舌（比喻不该说而说了）
炒面捏白头翁	老熟人
炒面捏娃娃	熟人
炒面捏窝窝（窝窝头。玉米面、高梁面等做的食物，略呈圆锥形，底下有窝儿）	捏不拢；难捏合
炒熟的黄豆	难发芽
炒熟的虾仁	红透了
炒熟了的豆子	发不了芽
炒虾等不得红	性太急
炒咸菜不放盐	有言（盐）在先
炒咸菜放盐巴	太闲（咸）了・
车道沟里的泥鳅	翻不了大浪
车干塘水捉鱼	只图一回；不顾后患
车沟里翻船	不可能的事；没人见过；没有的事；不可能
车后拴小牛	歹毒（带犊）
车辆对开	各走一边
车轮子没轴	转不开
车屁股安发动机	后劲大
车有车道，船有航道	各有各的路
车载千斤有地担	与己无关
车站上的蚊子	专跟过路人作对
扯掉画皮的恶鬼	凶相毕露
扯掉画皮的恶魂	凶相毕霹
扯裤子补补丁	堵不完的窟窿
扯乱了的线轴	找不到头
扯旗杆放炮	生怕别人不知道
扯起眉毛哄眼睛	自己哄自己；自欺欺人
扯着耳朵洗鼻涕	不对路数
扯着胡子打滴溜	嘴巴上的劲儿
扯着老虎尾巴喊救命	找死
沉香木当柴烧	用材不当
陈年谷子烂芝麻	不新鲜
陈年老账	没法了结
陈胜扯旗	揭竿而起
陈世美不认秦香莲	喜新厌旧
陈世美打轿夫	不识抬举
陈世美杀妻	忘恩负义
陈世美做附马	喜新厌旧
陈抟的徒弟	好睡
称秸秆儿扎的鸡	插翅也难飞
趁圪台（ge toi小土丘）下马	自找台阶
趁热打铁	正在火候上
趁水和泥，趁火打铁	一举两得
趁水踏沉船	助人为恶
趁着大风扫街	假积极
趁着热汤下笊篱（zhao li捞取东西的用具。用金属丝、篾条或柳条等编成。有长柄）	赶紧
撑船不要篙	放任自流
撑船不用篙	任其自流
撑船的老板	看风使舵
撑阳伞戴凉帽	多此一举
成对的蝴蝶	比翼双飞
成立皮包公司	做无本生意
成熟的莲子	心里苦
成熟的南瓜	黄了
城隍出主意	诡（鬼）计多端
城隍老爷发神经	魂迷心窍
城隍老爷拉胡琴	鬼扯
城隍老爷卖胡豆（蚕豆）	鬼吵（炒）
城隍老爷剃脑壳	鬼头鬼脑
城隍庙里摆菩萨	站就站一生，坐也坐
城隍庙里朝观音	走错了门
城隍庙里扯牌九	鬼场合
城隍庙里穿裤	羞死鬼
城隍庙里的判官	毗牙咧嘴
城隍庙里的小鬼	老瞪眼睛不开腔
城隍庙里的猪头	有主的
城隍庙里卖假药	哄鬼
城隍庙里内讧	鬼打鬼
城隍庙里闹内讧	鬼打鬼
城隍庙里小鬼	老瞪眼睛不开腔
城隍庙里着了火	小鬼的嘴里都冒烟
城隍奶奶怀孕	出了鬼胎
城隍奶奶烧柴灶	鬼火直冒
城隍娘娘怀孩子	怀鬼胎
城隍娘娘有喜	怀的鬼胎
城隍娘娘坐月子	养神
城隍菩萨拉二胡	鬼扯
城隍爷不穿裤	羞死鬼
城隍爷的马	样子货
城隍爷躲债	穷鬼
城隍爷拉胡琴	鬼扯
城隍爷扑蝴蝶	慌了神
城隍找土地爷拉呱儿（闲谈）	神聊
城隍皱眉头	鬼点子多；尽出鬼点子
城楼上的卫兵	高手（守）
城楼上看马打架	与我无关；与己无关
城楼上看人	眼光大高
城楼上亮相	高姿态
城门洞里打竹竿	直来直去；直进直出
城门洞里的砖头	蹋进蹋出
城门楼上吊大钟	群众观点
城墙上出丧	死出风头
城墙上的草	风吹两边倒
城墙上挂钥匙	开诚（城）相见
城墙上拉屎	出臭风头
城头上出殡	绕一个大弯儿（比喻有事不直说，而是拐弯抹角地去说。）
城头上盖城楼	底子空
城头上跑马	兜圈子
城外摆摊	外行
城外头开钱庄	外行
乘车误了点	赶不上趟
乘字底下丢了人	真乖
程咬金拜大旗	众望所归
程咬金打仗	全靠三板斧
程咬金的斧头	就那么几下子；头
程咬金的斧子	头三下（比喻做事起初声势很大，后不能坚持。）；头三下狠
程咬金的三斧头	虎头蛇尾
程咬金的招数	三板斧
程咬金上阵	就那三板斧
程咬金做皇帝	当不得真
秤锤掉在鸡窝里	捣蛋
秤杆掉了星	不识斤两
秤杆塞肚腹	满肚子点子
秤杆与秤砣	密不可分
秤杆子拄路	小心（星）点
秤钩打针	以曲求伸
秤钩吊在屁股上	自称自
秤钩子钓鱼	捞不着
秤砣掉进大海里	富（浮）不起来
秤砣掉进棉花堆	不声不响；无声无息
秤砣掉井里	硬到底
秤砣掉在井里头	不懂（咚）
秤砣掉在棉被上	没有回音（比喻某件事情没有得到回答，或没有落到实处）
秤砣过河	不服（浮）
秤砣囫囵（hd lun完整；整个儿）吞	铁了心
秤砣落井	硬到底
秤砣碰铁蛋	硬对硬
秤砣下河	非沉不可
秤砣砸核桃	看他硬到几时
吃罢黄连劝儿媳	苦口婆心
吃霸王的饭，给刘邦干事	不是真心
吃棒子面（玉米面）打哈欠	开黄腔
吃饱就睡的猫	哪能捉住耗子
吃冰棍拉（排泄）冰棍	没话（化）
吃不来烧红薯	一不会捧，一会拍
吃曹操的饭，干刘备的事	吃里爬外
吃曹操的饭，想刘备的事	人在心不在
吃刺扎嗓子	自找罪受
吃错了耗子药	胡折腾
吃得耳朵都动弹	味道好爽
吃点心抹酱油	不对味；不是味儿
吃豆腐怕扎牙根	小心过分
吃豆腐渣长大的	嘴松
吃多了碎米	罗唆
吃多了盐	尽讲闲（咸）话
吃饭馆，住旅店	啥事不管
吃饭泡米汤	喝粥的命
吃饭舔碗边	穷相毕露；吝啬鬼
吃蜂蜜说好话	甜言蜜语
吃蜂蜜蘸（zhon）葱	找死；送死；自己找死
吃根灯草	说话轻
吃狗肉喝白酒	里外发烧
吃瓜子吃出虾米来	什么人（仁）都有
吃瓜子	吞吞吐吐
吃挂面不调盐	有言（盐）在先
吃过黄连喝蜂蜜	先苦后甜
吃过黄连喝蜜糖	苦尽甘来
吃过三斤老蒜头	好大的口气
吃过晌饭（午饭）打更	不是时候；为时过早；不看时候；早得很
吃过屎的狗	嘴巴臭
吃过响午搭早车	不赶趟
吃海水长大的	管得宽
吃河长大的	营得宽
吃红薯蘸（zhan）蒜汁	不对口味；不是味儿
吃鸡蛋不拿钱	混蛋
吃家饭屙（e排泄）野屎	吃里爬外
吃口樱桃肉塞了嗓子眼	小心眼；心眼小
吃苦菜长大的	没尝过甜头
吃辣的送海椒（辣椒），吃甜的送蛋糕	投其所好
吃辣的送海椒，吃甜的送蛋糕	投其所好
吃辣椒喝白干	里外发烧
吃雷公屙火闪	胆大包天
吃了豹子胆	胆子大
吃了扁担	横了肠子
吃了冰糖吃豆腐	先硬后软
吃了秤舵	铁心了（比喻下了决心了不可改变。或比喻狠了心，心肠硬，不为感情所动。）
吃了秤杆	一肚子心眼
吃了冬眠灵	昏昏欲睡
吃了豆腐	软了心
吃了对门谢隔壁	晕头转向
吃了蜂蜜	心里甜
吃了虎豹的心肝	好大的胆子
吃了黄连吃甘草	先苦后甜
吃了鸡下巴	爱搭嘴
吃了蒺藜（ji li一年生草本植物。果皮有尖刺）豆	扎心
吃了筐烂杏	心酸
吃了雷公的胆	天不怕地不怕
吃了蒙汗药	任人摆布
吃了磨刀水的	锈气在内
吃了木炭	黑了良心
吃了鸟枪药	火气冲天
吃了砒霜（pi shuang砷的氧化物。剧毒）的老母鸡	抬不起头来
吃了砒霜毒狗	害人先害己
吃了砒霜再上吊	必死无疑；死定了
吃了三碗红豆饭	满肚子相思
吃了生铁	变硬了
吃了算盘子	心里有数
吃了五味想六味	贪得无厌
吃了线团子	心里结疙瘩
吃了蝎子	心肠歹毒
吃了一包回形针	一肚子委屈（曲）
吃了一堆烂芝麻	满肚子坏点子
吃了鱼钩的牛打架	勾心斗角
吃了芋头不下肚	顶心顶肺（比喻心中忿忿不平，忍受不下去。或心里不好受。）
吃了早饭睡午觉	乱了时辰
吃了猪下巴	爱搭嘴
吃柳条拉筐子	肚子里编（比喻某件不是真的，是人编造出来的。）
吃柳条拉笊篱（zhao li捞取东西的用具。用金属丝、蔑条或柳条等编成。有长柄）	肚子编
吃萝卜喝烧酒	千干脆脆
吃米不记种田人	忘本
吃米饭拣谷子	挑剔
吃棉花拉线团	肚里有文章
吃面条找头子	多余
吃秦椒（细长的辣椒）烤火	周身火热
吃桑叶吐丝	肚里有货
吃上辣椒屙不下	两头难受
吃烧饼掉芝麻	免不了
吃生米的碰到嗑生谷的	恶人遇恶人
吃剩饭长大的	尽出馊主意
吃屎狗难断吃屎路	本性难移
吃死老公（丈夫）睡塌床	懒婆娘
吃死老公睡崩床	懒婆娘
吃天风	高傲
吃甜的有蜜糖，吃辣的有辣汤	各对口味
吃歪藤长大的	乱纠缠
吃豌豆咽鸡蛋	一个赛一个
吃完饭就砸锅	不干了
吃窝头就辣椒	图爽快
吃稀饭泡米汤	多余
吃稀饭泡汤	亲（清）上加亲（清）
吃下苍蝇	直感到恶心
吃咸菜长大的	尽管闲（咸）事
吃咸菜蘸酱油	多此一举
吃咸鱼蘸酱油	多此一举
吃馅儿饼抹油	白搭
吃一升米的饭，管一斗米的事	管得宽
吃鱼不吐骨头	说话带刺儿
吃鱼不沾腥	全凭张好嘴
吃枣子不吐核	囫囵（hu lun完整儿）吞枣
吃斋的恶婆子	口素心不善
吃猪肉念佛经	假善人
吃竹竿长大的	直性人
吃竹子拉笊篱（zhao li捞取东西的用具丝、蔑条或柳务等编成。有长柄）	瞎编
吃着冰棍拉家常	冷言冷语
吃着菠萝问酸甜	明知故问
吃着肥肉唱歌	油腔滑调
吃着话梅讲话	一股酸味
吃着黄连唱歌	以苦为乐
吃着黄连唱着歌	以苦为乐
吃着梅子问酸甜	明知故问
吃着碗里瞧着锅里	贪婪
吃着油条唱歌	油腔滑调
痴鸟等湖干	痴心妄想
痴情碰冷遇	伤透心肝
池里的王八，塘里的鳖	一路货
池塘里的荷叶	随风摆
池塘里的癞蛤蟆	叫起来没个完（比喻没完没了。）
池塘里的莲藕	嫩的好
池塘里的麻雀	没见过风浪
池塘里的泥鳅	掀不起大浪
池塘里的藕	心眼儿多
池塘里的鱼	没见过风浪
池塘里摸菩萨	劳（捞）神
池塘里洗澡	未必就干净
池中捞藕	拖泥带水
赤膊钻进蒺藜（ji li一年生草本植物。果皮有尖刺）窝	浑身是刺
赤脚拜观音	诚心实意
赤脚戴礼帽	顾头不顾尾
赤脚的和尚	两头光
赤脚的撵（nian追赶）穿高跟鞋的	赶时髦
赤滤膊桶马蜂窝	不惜血本；蛮干
翅膀长硬的鸟	要飞了
冲锋枪上的通条	直来直去；难转弯；转不过弯来
冲沟里放牛	两边吃（比喻两面受益，好处很多。）
冲瞎子问路	找错了人
冲着和尚骂秃子	寻着惹气
冲着柳树要枣吃	有意为难
冲着姨夫叫丈人	乱认亲
虫吃沙梨	心里肯（啃）
虫蛀的扁担	经不住两头压
虫蛀的老槐树	腹内空空
虫蛀的苹果	放到哪，烂到哪
虫子钻进核桃里	冒充好人（仁）
崇赖上吊	走投无路
崇桢皇帝上吊	走投无路
宠了媳妇得罪娘	两头为难；左右为难
抽大烟的说梦话	不过瘾
抽风攥（zuan握）拳头	手紧
抽了脊梁骨的癞皮狗	扶不上墙
抽芽的蒜头	多心
抽烟打吗啡	一码是一码
仇人相见	分外眼红
绸子包鸡笼	外面好看里面空
绸子揩屁股	不惜代价
丑八怪出台	见笑了
丑八怪戴花	不知自丑
丑八怪相媳妇	乔装打扮
丑姑娘嫁俊女婿	混着过（比喻苟且地生活。）
丑女嫁丑汉	丑上加丑
丑婆娘逛灯	活现眼
丑媳妇见公婆	迟早一回；迟早有
丑小鸭变天鹅	高升了
臭虫咬胖子	揩油
臭虫咬人	出嘴不出身
臭豆腐	闻着臭，吃着香
臭狗舍不得臭屎坑	本性难移
臭鸡蛋	不甩不行
臭媚眼做给瞎子看	莫名其妙
臭水坑里的核桃	不是好人（仁）
出巢的蜜蜂	满天飞
出得龙潭，又入虎穴	祸不单行；躲了一灾又一灾
出东门，往西拐	糊涂东西
出洞的老鼠	左顾右盼；东张西望
出工一条龙，干活一窝蜂	出勤不出力
出锅的大虾	卑躬（背弓）屈膝
出锅的烧鸡	窝着脖子别着腿
出国的大轮船	外行（航）
出家人娶媳妇	不守规矩
出嫁的姑娘	有主了
出口转内销	掉价了
出了厨房进冰窖	忽冷忽热
出了灯火钱，坐在暗地里	吃明亏
出了笼的黄雀	自由自在
出了炉的纯钢	宁折不弯
出了土的笋子	冒尖
出了芽的蒜头	多心
出了窑的砖	定型了
出笼的鸟儿	有去无回
出炉的铁水	沾不得
出门带伞	有备无患
出门戴口罩	嘴上一套
出门逢债主，回屋难揭锅	内外交困
出门逢债主	扫兴；倒霉透了
出门坐飞机	远走高飞
出山的太阳	一片火红；火红
出水的芙蓉	一尘不染
出水的虾	又蹦又跳；连蹦带跳
出水的英蓉	楚楚动人
出膛的子弹	不会拐弯
出头椽子	先烂
出头的椽于（chuan zi）	先烂
出头的钉子	先挨砸
出土的甘蔗	节节甜
出土的陶俑	总算有了出头之日
出土的竹笋	捂不住
出土笋子逢春雨	节节高
出须的萝卜	肚里空
出衙门骂大街	没事找事
出窑的石灰遭雨淋	四分五裂
初二三的月亮	不明不白
初七八的月亮	半边阴
初晴露太阳	重见天日；开云见日
初升的太阳	光芒四射；一片红火；火红一片
初生的牛犊	不怕虎
初生的娃娃	小手小脚
初生犊	不怕虎（比喻年轻人大胆勇敢但缺少经验。）
初一吃十五的饭	前吃后空
除夕晚上借砧板	不看时候
除夕夜守岁	除旧迎新
厨房里打架	砸锅
厨房里的馋猫	记吃不记打
厨房里的火筒	两头空
厨房里的垃圾	鸡毛蒜皮
厨房里的猫	总不记打（比喻一直不接受教训。）
厨房旁边盖茅厕（mao se厕所）	香香臭臭
厨师的围裙	油透了
厨子（厨师）搬家	另起炉灶
厨子炒菜	添油加醋
锄头刨黄连	挖苦
楚霸王举鼎	好大的力气
楚霸王种蒜	栽到家了
楚霸王自刎	身败名裂
楚霸王自刎乌江	没脸回江东
楚汉相争	势不两立
楚庄王猜谜语	一鸣惊人（比喻平常不露声色，突然作出惊人的事情。）
楚庄王理政	一鸣惊人
穿背心戴棉帽	不相称
穿背心作揖	霹两手
穿冰鞋上沙滩	你别想溜
穿草鞋打领带	土洋结合
穿草鞋戴礼帽	不伦不类；不相称
穿长衫着短裤	不配套
穿绸缎吃粗糠	外光里不光
穿绸子吃粗糠	表面光
穿钉鞋踩瓦屋	捅漏子
穿钉鞋外搭拄拐杖	双保险
穿钉鞋走泥路	步步有点
穿冬衣戴夏帽	不知春秋
穿冬衣摇夏扇	不知冷热
穿短袜着短裤	拉扯不上
穿高跟鞋跑步	想快也快不了
穿寒衣摇夏扇	不知冷热（比喻不知好歹。）
穿汗衫戴棉帽	不知春秋
穿紧身马褂长大的	贴心
穿孔的皮球	泄了气
穿裤扎脚音	毫毛不丢一根
穿凉鞋戴棉帽	顾头不顾脚；不知春秋
穿了鼻子的牛	让人牵着走
穿了三年的乌拉（wu la东北地区冬天穿的鞋用皮革制成。里面垫乌拉草）	破鞋
穿棉衣打扇	不知春秋
穿木屐（mu ji木板拖鞋）干活	拖拖拉拉
穿木屐过摩天岭	走险
穿木屐上高墙	胆战心惊；战战兢兢
穿皮袄打赤脚	凉了半截
穿皮袜子戴皮手套	毛手毛脚．
穿破衫戴礼帽	不成体统
穿旗袍跳芭蕾舞	中西结合
穿山甲的本事	会钻的勇气和胆量
穿梭子不带线	空来空往
穿蓑衣救火	引火烧身
穿兔子鞋的	跑得快
穿拖鞋戴礼帽	不伦不类
穿拖鞋跳芭蕾舞	洋不洋土不土
穿袜子没底	装面子
穿西装戴草帽	不土不洋；半土半洋
穿心的烂冬瓜	坏透／
穿新鞋走老路	因循守旧
穿新衣逛新城	样样新鲜
穿靴子光脚	自己心里明白
穿衣戴帽	各有一套
穿衣镜前作揖	自己恭维自己
穿衣镜照人	原原本本
穿着高跟鞋上山	自己跟自己过不去
穿着汗衫戴棉帽	不相称（比喻不合适。）
穿着棉衣游泳	甩不开膀子
穿着孝服拜天地	悲喜交加；又喜又悲
传说中的八仙	各有千秋
传闲话，落不是	自讨没趣
船板做棺材	漂流了半辈子，老来才成（盛）人
船帮做棺材	漂流了半辈子才成（盛
船到江心才补漏	晚了
船到码头车到站	停滞（止）不前
船到桥头	不顺也得顺
船到竹稿撑	随机应变
船底浇花	多此一举
船进断头浜（bang小河）	进退两难
船老大带徒弟	从何（河）说起
船老大的犁头	没用处
船老大敬神	为何（河）
船老大坐后艄	看风使舵
船上打伞	没天没地
船上的钟表	有行时
船上扭秧歌	载歌载舞
船上失火	有底
船头办酒席	难铺排
船头上跑马	走投无路
船头上撒网	纲举目张
串起来的螃蟹	横行不了几天
串绳子养海带	棍子在上头
疮口上贴膏药	揭不得
窗户棂里吹喇叭	名（鸣）声在外
窗户上的纸	一桶就穿
窗户上画老虎	吓不了谁
窗户上伸脚	走错了门；不是门
窗户眼儿吹喇叭	名（鸣）声在外
窗户眼里看人	小瞧
窗户纸	一戳就透
窗口插桂花	里外香
窗纱做衣裳	浑身是窟窿
窗台上种瓜	长不大
床扳夹屁股	有苦讲不出
床板夹屁股	有苦说不出；有苦难诉
床单做鞋垫	大材小用
床底下拜年	伸不直腰
床底下吹号	低声下气
床底下吹喇叭	低声下气
床底下的夜壶	离不得又见不得
床底下点灯	不高明
床底下翻跟头	碍上碍下
床底下放风筝	不见起
床底下关鸡	提（啼）醒你
床底下鞠躬	抬不起头来
床底下练武	施展不开
床底下亮相	姿态不高
床底下抡大斧	不好使家伙
床底下劈柴	难免磕磕碰碰
床底下晒被子	阴干
床底下晒谷子	阴干
床底下伸手	要求不高
床底下想办法	主意不高
床底下支张弓	暗箭伤人
床上的花枕头	置之脑后
床上铺黄连	困苦
床上失火	烧着屁股燎着心
床上耍花枪	打不开场面
床上杂耍	软功夫
床上捉奸	想赖也赖不了
床头上拾钱	自己哄自己
吹灯拔蜡踩锅台	一切都完了
吹灯打哈欠	暗中出气；偷偷消气
吹灯讲故事	瞎说
吹灯捉虱子	瞎摸
吹笛的会摸眼，打牌的会摸点	各有本领
吹笛又找个捏眼的	多余
吹风机出故障	坏了风气
吹鼓手吃饭	顾吃不顾吹
吹鼓手的腮帮子	鼓起来了
吹鼓手掉进井里	想（响）着想（响）着下去了
吹鼓手丢唢呐	吹不得
吹鼓手分家	一人一把号
吹鼓手赴宴	吃的胀气饭
吹鼓手赶集	没事找事（比喻自找麻烦，自寻烦恼。）
吹鼓手仰脖子	起高调
吹鼓手坐宴席	顾吃不顾吹
吹胡子瞪眼	气到极点
吹回哨过坟场	自己给自己壮胆（比喻本来心虚，有所畏惧，却设法使自己镇，以增加自己的勇气和胆量。）
吹火筒当望远镜	眼光狭窄
吹火筒子	两头受气；两头通
吹口哨过坟场	自己给自己壮胆
吹喇叭的分家	挨不上号
吹喇叭响爆竹	有鸣有放
吹喇叭扬脖	起高调（比喻说不切实际的漂亮话。）
吹灭灯挤眼儿	看不见的勾当
吹起来的肥皂泡	不攻自破
吹气人竹笼	劳而无功
吹糖人的出身	好大的口气；口气不小
吹糖人的改行	不想做人
炊事员行军	替人背黑锅
锤打铜锣	一撞就响
锤砸铁钻	响当当（比喻本事过硬，远近闻名，很有影响。）
锤子炒菜	砸锅
锤子敲钉子	人木三分
春蚕到死	怀着丝
春草闹堂	急中生智
春茶尖儿	又鲜又嫩
春凳（宽而长的旧式凳子）折了靠背儿	无靠
春江水暖	鸭先知
春苗得雨	正逢时
春笋破土	节节高；天天向上
春天的草芽	自发
春天的雷，涨潮的水	留不住
春天的柳树枝	落地生根
春天的蜜蜂	闲不住
春天的石榴花	心红
春天的杨柳	分外亲（青）
春天的竹笋	节节向上；无依
春汛的鱼虾	随大流
戳翻了的蚂蚁窝	全暴露了
戳破了的灯泡	冒火
瓷公鸡，玻璃猫	一毛不拔
瓷器店里的老鼠	打不得；碰不得
慈禧太后手下的光绪皇帝	当家不做主；有职无权；
慈禧太后听政	独断专行
磁石遇铁砣	不谋而合
糍耙（ci ba）打狗	沾上了
此地无银三百两	不打自招；自己哄自己；自欺欺人
此曲只应天上有	不同凡响
刺笆（荆棘）林里的斑鸠	不知春秋
刺笆林里放风筝	胡搅蛮缠；胡缠
刺槐作棒槌	净是扎手货
刺木架桥	没人敢过
刺猬的脑袋	不是好剃的头
刺猬钻进蒺藜（ji li一年生草本植物。果皮有尖刺）窝	针锋相对
刺窝里摘花	下不了手；无法下手
从恶水（泔水）缸跳到茅坑里	越闹越臭
从发面团里拔毛	无中生有
从狗洞里爬出来新郎	不走正道
从河南到湖南	难（南）上加难（南）
从糠里熬出油来	是把好手
从门缝里看人	把人看扁了
从墓坑里爬上来	死里求生
从潲水缸里出来的	一身馊味
从石头里挤水	办不到
从小差一岁	到老不同年
从小娇惯的公主	随心所欲
从小没娘	说来话长
从盐店里闹出来的伙计	闲（咸）得发慌
从一算起	接二连三
葱皮筒子	经不起吹
葱头不开花	装什么蒜
葱叶炒藕	空对空
粗糠烙饼	好看不好吃
粗麻绳纫针（ren zhe引线穿过针鼻儿）	难上加难
醋厂里冒烟	酸气冲天
醋熘猪苦胆	又苦又酸。
醋泡的蘑菇	坏不了
醋坛里打酒	满不在乎（壶）
醋坛里酿酒	坛坛酸
醋坛里泡枣核	尖酸
醋坛子里泡胡椒	尝尽辛酸
窜蛇盯小鸟	列奏（逮住）
崔莺莺患病	心病还得心药医
崔莺莺送郎	依依不舍；一片伤心说不出；不出的伤心
催命鬼对阎王	一个比一个凶
脆瓜打狗	零碎
脆瓜打驴	去一半
淬过火的钢条	宁折不弯
矬地炮（个子矮小的人。矬，cuo）个细高挑儿（身材细长的人）	取长补短
矬子（个子矮的人）公	坐地使法
矬子打呵欠	气儿不长
矬子爬墙头	想出人头地；巴不得
矬子骑骆驼	上下两难
错把驼峰当肿背	大惊小怪
错把洋芋当天麻	不知好歹；好歹不分
错公穿了错婆鞋	错上加错
错贴的门神	翻（反）了脸
搭房子封屋顶	铺天盖地
搭锯见末，水到渠成	立竿见影
搭棚子卖绣花针	买卖不大，架子不小
搭起牌楼卖酸枣	买卖不大，架子不小
搭起戏台卖豆腐	买卖不大架子大
搭起戏台卖螃蟹	货色不多，架势不大（比喻表面上气势汹汹，而内里却空虚怯弱）
搭起戏台卖酸枣	架子不小
搭人梯过城墙	踩着别人的肩膀往上爬
搭梯子上天	走投无路
搭戏台卖豆腐	好大的架子
褡裢（da lian中间开口的长方形口袋）背水	从前心凉到后心；冷透心；凉透心
打靶不中	偏了心
打靶中靶心	恰到好处；不偏不倚
打败的鹌鹑斗败的鸡	上不了阵势
打饱嗝带放屁	两头没好气；气不打一处来
打不完的官司	扯不完的皮
打不着狐狸弄身臊	自背臭名
打草人拜石像	欺软怕硬
打柴人回山庄	两头担心（薪）
打赤脚赶场	脚踏实地
打出的子弹射出的箭	永不回头
打出枪膛的子弹	有去无回
打醋的进当铺	走错了门；找错了门
打灯笼走亲戚	明去明来（①比喻事情公开进行。②有话直说，有拐弯抹角。）
打灯笼走铁道	见鬼（轨）
打灯笼做事	照办
打电话遇忙音	不通
打断脊梁骨的癞皮狗	腰杆子不硬
打断了的胳膊	拄外拐（比喻说话、办事向着外人。）
打发闺女娶媳妇	两头忙
打翻了五味瓶	不知啥滋味；酸甜苦辣咸，样样都有
打更人睡觉	做事不当事
打狗不赢咬鸡	欺小怯大
打狗看主人	势利眼
打鼓不打面	旁敲侧击
打官司的上堂	各执一词
打好的鱼网	心眼儿多（比喻很有心计。）
打火机点烟袋锅	土洋结合
打架揪胡子	谦虚（牵须）
打架脱衣服	赤膊上阵
打酒只问提壶人	错不了
打开棺材喊捉贼	冤枉死人
打开棺材治好病	起死回生
打开笼子放了雀	各奔前程
打开密罐又撒糖	要多甜有多甜
打开天窗	说亮话（比喻不必遮掩，直截了当出。）
打开闸门的水	滚滚向前
打瞌睡的捡了个枕头	正好
打烂的暖水瓶	丧胆
打烂的油瓶	全倒光
打烂门牙咽肚里	干吃哑巴亏；吃了哑巴亏
打了败仗的士兵	溃不成军
打了的鱼缸	四分五裂
打了瓶子洒了油	两头不落一头
打了霜的烟叶	蔫（nian花木、水果等因失去水分而萎缩）了
打了兔子喂鹰	好处给了恶人
打猎的不说鱼网，卖驴的不说牛羊	三句话不离本行
打猎放羊	各干一行
打猎人瞄准	睁只眼，闭只眼
打猎忘了带猎枪	丢三落（la）四
打锣卖糖	各干一行
打麦场上撒网	空扑一场
打鸟没打中	非（飞）也
打鸟人的眼睛	尽往上看（比喻眼高，净交些有用人。）
打鸟姿态	睁只眼，闭只眼
打乒乓玩排球	推来推去；互相推托
打破的镜子	难重圆
打破脑袋不喊痛	充硬汉
打破脑袋拿扇子扇	豁出去了
打破沙锅问（璺）到底	追根到底；追根求源
打破嘴巴骂大街	血口喷人
打枪不瞄准	无的放矢
打人嘴巴还吐唾沫	欺人太甚
打伞披雨衣	多此一举
打煞男人，吓唬公婆	泼妇
打煞爷讨娘喜欢	岂有此理
打扇抽烟	煽（扇）风点火
打上黑脸照镜子	自己吓唬自己
打蛇不死打蚯蚓	怯大欺小
打蛇不死	后患无穷
打蛇打到七寸上	正好；恰到好处;击中要害；抓住了关键
打蛇打七寸	攻其要害
打蛇随棍上	因势利导，
打手击掌	一言为定
打手赛拳	各有一套
打水不关水龙头	任其自流：放任自流
打水摇辘轳（lu lu）	抓住把柄了
打死儿子毒死闺女	自家人害自家人
打死儿子招女婿	图新鲜
打死扣的绳结	越拉越紧
打死老鼠喂猫	好一个，恼一个
打死蚂蚁踩一脚	做得出来
打碎的盘子，敲烂的碗	对不起
打铁不看火色	傻干
打铁的拆炉子	散伙（火）
打铁的分家	另起炉灶
打铁掉地下	白搭一火
打铁卖糖	各干一行
打兔子捉到黄羊	捞外快；格外
打完架就握手	不打不相识
打围碰到金钱豹	笑逐颜开；喜笑颜开
打蚊子喂象	不顶用；无济无事
打下去的桩头	定了
打响雷不下雨	一场虚惊；虚惊
打一巴掌揉三揉	虚情假意；假情假义
打一拳头给块糖	堵人家的嘴
打油的漏斗	没底儿
打油钱不买醋	专款专用
打鱼的烂网	千疮百孔
打鱼子（渔夫）碰烂船	倾家荡产
打枣捎带沾知了	一举两得
打胀的皮球	一肚子气
打针鼻眼里往外望	小瞧死人了（比喻过低评价人，或非常看不起人。）
打针吃黄连	痛苦
打肿脸充胖子	死要面子活受罪；外强里虚；冒充富态
打准腰部才罢休	正中下怀
打着灯笼没处找	难得；得之不易
打着灯笼拾粪	找死（屎）
打着灯笼偷驴子	明人不做暗事
打着公鸡下蛋	强人所难
打着手电筒走夜路	前途光明
打着兔子跑了马	得不偿失
打字机上的字盘	横竖不成话
打足了气的皮球	一蹦老高
打足气的皮球	跳三尺高
打足气的气球	早晚要炸
大白公鸡下花花蛋	离奇；太离奇
大白天出星星	离奇；太离奇
大白天打更	乱了时辰
大白天打劫	明目张胆
大白天见阎王	活见鬼
大白天里抢劫	明火执仗
大白天遇见阎王爷	活见鬼
大白天掌灯	多此一举
大鼻子的爸爸	老鼻子啦
大伯墓前哭爹	上错了坟
大草原上吹喇叭	想（响）得宽
大车后面拴小牛	歹毒（带犊）
大车拉煎饼	贪（摊）得多
大虫（老虎）吃耗子	囫囵（hu lun完整；整个儿）吞
大虫打哈哈	笑面虎
大虫借猪	有借无还
大虫口里夺脆骨，骊龙颌下取明珠	好大胆；好大的胆子；找死
大虫头，长虫（蛇）尾	虎头蛇尾
大船开到小河沟	搁浅
大船开到小河里	搁浅
大船离港	外行（航）
大船漏水	有进无出
大船载太阳	勉强度（渡）日
大槌敲鼓	声声人耳
大刀砍虱子	不合算
大刀斩小鸡	小题大作
大道边的驴	谁爱骑谁骑
大道边上贴布告	路人皆知
大道上的驴	你不骑我骑
大道上洒香水，小道上捡芝麻	大处不算小处算
大吊车吊灯草	轻巧；轻拿；不值
大吊车吊蚂蚁	轻而易举
大肚罗汉吹喇叭	一团和气
大肚罗汉戏观音	睁只眼，闭只眼
大肚子不生孩子	尽背虚名
大肚子踩钢丝	铤（挺）而走险
大肚子老婆骑驴	靠前不行，靠后也不行
大肚子上班	挺着干
大粪车出村	装死（屎）
大粪池里游泳	不怕死（屎）
大粪缸里练游泳	真是不怕死（屎）
大风吹倒帅字旗	出师不利
大风吹倒梧桐树	自有旁人说短长；有的说短，有的说长
大风吹倒玉瓶梅	落花流水
大风吹翻麦草垛	乱七八糟
大风地里吃炒面	有口难开（比喻张口结舌，说不出话来。）
大风地里点油灯	一吹就了
大风刮倒了帅旗	出师不利
大风卷小雪	吹了
大风天吃炒面	不好张口；难张口
大风天卖炒面	吹了
大佛殿的罗汉	一肚子泥（比喻徒有外表而无真才实学的人）
大佛殿的菩萨	满肚子泥；
大佛寺的大佛	半身金装
大缸里放针	粗中有细
大缸里摸鱼	没跑；跑不了
大个子盖小人被	顾头不顾脚
大公鸡吃米	不计其数
大公鸡打架	全仗着嘴
大姑娘拜天地	头一回；头一遭
大姑娘抱孩子	人家的
大姑娘不要婆家	假的
大姑娘裁尿布	早作准备；赶早不赶晚；闲时置了忙时用
大姑娘出嫁	又喜又怕
大姑娘穿花鞋	走着瞧
大姑娘当媒人	先人后已；有嘴讲别人，没嘴讲自己
大姑娘的长辫子	置之脑后
大姑娘的脊梁	女流之辈（背）
大姑娘的脸蛋	摸不得
大姑娘的心事	摸不透
大姑娘缝娃娃衣	总有用着的时候
大姑娘嫁太监	享福没有受苦多
大姑娘盼闺女	想得太早
大姑娘瞧嫁妆	有口子的人了
大姑娘瞧新房	有日子的人啦
大姑娘上轿	头一回；头一遭；脸上哭，心里笑
大姑娘生的	见不得人
大姑娘说媒	有口难言
大姑娘讨饭	死心眼；拉不开脸面
大姑娘相女婿	羞羞答答
大姑娘绣花	细功夫；九曲十八弯
大姑娘绣嫁衣	穿针引线；细功夫
大姑娘要婆家	有话难说
大姑娘掌钥匙	当家不做主
大姑娘肿脸	难看（比喻当众出丑。丑陋、不好看。）
大姑娘坐花轿	迟早一回；迟早的事
大姑娘做嫁衣	闲时预备忙时用
大姑娘做客	羞羞答答
大牯牛落井里	有劲使不上；有力无处使
大观园里哭贾母	各有各的伤心处
大管子套小管子	不对口径
大闺女裁尿布	闲里置下忙来用
大闺女的荷包	花色多
大闺女的围巾	绕脖子
大闺女的鞋	花样多
大闺女怀孕	满腹心事说不出
大闺女买假发	随便（辫）
大闺女盼郎	朝思暮想
大闺女上轿	慢慢蹭
大闺女退婚礼	不谈了
大闺女相亲	羞羞答答
大锅里熬鱼	水里来；汤里去
大海，翻了豆腐船	水里来，水里去
大海里捕鱼，深山里打猎	各吃一方
大海里荡舟	划不来
大海里的灯塔	光芒四射；指明航程
大海里的浮萍	没着落
大海里的黄花鱼	掀不起大浪；翻不了大浪
大海里的沙粒	数不清；有的是
大海里的水雷	一触即发
大海里的小船	风雨飘摇
大海里的一滴水	缈小得很；有你不多没你不少
大海里的鱼	经过风浪
大海里丢针	难寻；没处寻
大海里放鸭子	难收回；收不回来
大海里放鱼	各奔一方
大海里刮旋风	谁（水）也转
大海里捞针	难寻；无法摸不着底
大海里吐唾沫	不显眼
大海里下竿子	不知深浅
大海里行船，草原上放牧	不着边
大海里行船	乘风破浪；摸不着边；漫无边际
大海里腌咸菜	白费工夫；白费劲
大海里一片叶	漂浮不定
大河边上的望江亭	近水楼台
大河决了堤	放任自流；任其自流
大河里漂油花	一星半点
大河里洗煤	闲着没事干
大黑天照镜子	没影的事
大胡子吃糖稀	撕扯不清
大花脸扮小生	改行
大花脸的胡子	假的
大花脸化妆	面目全非
大花脸舞刀	耍威风
大槐树底下等情人	急不可待
大槐树上挂电灯	四方有名（明）
大槐树下挂灯笼	四方有名（明）
大火烧到额头上	迫在眉睫
大火烧蚁窝	一举全歼
大鸡不吃碎米	看不上眼
大家看电影	有目共睹
大江东去	无休止
大江里漂浮萍	随波逐流
大江里一桶水	有你不多，无你不少
大江里抓鱼	人人有份
大脚穿小鞋	两头扯不来；难受；钱（前）紧；迈步难；硬撑
大脚女人	迈不出小步来
大街得信小街传	道听途说
大街上弹琴	听不听随你
大街上的挂钟	群众观点
大街上的红绿灯	有目共睹
大街上的乞丐	蓬头垢面
大街上的行人	有来有往：
大街上卖笛子	自吹
大街上相亲	一厢情愿
大金牙说媒	满口谎（黄）言
大镜子当供盘	明摆着
大卡车开进小巷子	难转弯；转不过弯来
大口啃住包子馅	抓重点
大口碗配个小盖子	合不拢；合不到
大懒使小懒	懒对懒
大榔头砸豆腐	笃定
大老爷的惊堂木	官气（器）
大老爷下轿	不（步）行
大老爷坐堂	吆五喝六
大理石铺路	大材小用
大理石做门匾	牌子硬
大力士耍扁担	轻而易举
大力士耍灯草	轻而易举
大力士绣花	心有余而力不足；力不从心；力不能及
大流子的弟弟	二流子
大龙不吃小干鱼	看不上眼
大篓洒香油，满地拾芝麻	得不偿失
大篓香油浇芝麻	得不偿失
大路边的草	谁爱割谁割
大路边上裁衣服	有的说短，有的说长；旁人说短长
大路边上打草鞋	有的说短，有的说长；自有旁人说短长
大路边上的碓窝（dui wo石臼）	人人用
大路旁的小草	有你不多，没你不少
大路上长青草	死里求生
大路上的石头	明摆
大路上的砖头	绊脚石；踢来踢去
大路上卖竹竿	这个说短那个说长
大路上螃蟹	横行霸道
大路上栽葱	白费功夫
大轮船出国	外行（航）
大轮船出海	通行无阻；畅通无阻
大轮船靠小港	挨不上
大轮船抛锚	稳稳当当
大萝卜进菜窖	没影（缨）了
大麻籽喂牲口	不是好料
大麻子喂麻雀	喂一个，跑一个
大麻子照镜子	个人观点
大马拉小车	有劲使不上；有力无处使
大麦芽做饴糖	好料子
大蟒吃猪娃	生吞活剥
大门板做棺材	屈才；用材不当
大门口的石狮子	成双成对
大门口吊马桶	臭名在外
大门口挂灯笼	一对儿
大门口挂红灯	美名（明）在外
大门楼里敲锣鼓	里外有名（鸣）声
大门上挂画	美名在外
大门上贴画儿	美名在外
大门外的砖	踢出来的
大门外的砖头	踢出来的
大米饭串烟	变味了
大眠起来的春蚕	满肚子私（丝）
大拇指搔痒	随上随下
大拇指搔痒痒	随上随下（比喻听凭支使，照吩咐办事。）
大拇指掏耳朵	难进
大拇指挖耳朵	进不去
大年初一拜年	你好我也好（比喻不肯得罪人）
大年初一吃饺子	随大流；年年都一样；人有我有；头一回
大年初一吃面条	移风易俗
大年初一打灯笼	年年都一样；年年如此
大年初一打拼伙	穷鬼们聚到一块了
大年初一打平伙	穷凑合
大年初一逮兔子	有它过年，无它也过年（比喻微不足多，增减都不影响大局。）
大年初一的袍子	借不得
大年初一翻皇历	头一回；头一遭
大年初一见于面	尽说好话
大年初一借袍子	不识时务；不是时候
大年初一看历书	日子长着哩
大年初一没月亮	年年都一样
大年初一生娃娃	双喜临门
大年初一贴福字	吉庆有余
大年初一早上见面	你好我也好
大年初一做月子	赶在节上
大年三十的案板	家家忙
大年三十的烟火	万紫千红
大年三十看皇历	没日子啦
大年三十看黄历	没有日子了（比喻到了尽头。）
大年三十盼月亮	痴心妄想；妄想
大年三十晚上熬稀饭	年关难过
大年三十晚上打兔子	有你不多，没你不少
大年三十晚上卖门神	再迟不过了
大年三十喂年猪	来不及了
大年午夜的鞭炮	天花乱坠
大年夜的爆竹声	此起彼落
大年夜的蒸糕	热门货
大年夜卖年画	不懂买卖经
大胖子穿小褂	不合身
大胖子骑瘦驴	不相称
大胖子推磨	杜撰（肚转）
大胖子走窄门	难进；自己跟自己过不去
大炮打麻雀	小题大作
大炮轰苍蝇	不够本钱；不够本；不合算；大材小用；白费工夫；枉费工
大炮上刺刀	远近全能对付；蛮干
大炮筒子	不会拐弯
大鹏展翅	前程万里
大笸箩（po luo盛谷物等的器具。用柳条或篾条等编成）扣王八	跑不了
大锹刨黄连	挖苦
大巧背小巧	巧上加巧
大晴天晒山芋干	干干脆脆
大热天穿皮袄	不是时候（比喻不合时宜。）
大热天捧个烂西瓜	想扔舍不得
大热天送火炉	不识时务
大热天下暴雨	猛一阵；长不了
大人不记小人过	宽宏大量
大人的演出	不是儿戏
大鲨鱼不吃小虾	看不上眼
大舌头读报	含糊其辞；含含糊糊
大声使铜银（把铜质货币当银质货币使用）	公开作假
大圣吹毫毛	变得真快
大师傅熬稀粥	不在话下
大师傅拆灶	散伙（火）
大师傅打蛋	各个击破
大师傅的肚子	油水多
大师傅下伙房	来了内行
大师傅蒸馍	不到火候不开锅
大石压死蟹	以势压人
大世界（旧指上海著名的游乐场）里照哈哈镜	面目全非
大树底下晒太阳	阴阳不分
大树掉片树叶	无关大体
大树林里一片叶	有你不多，没你不少
大树上吊个口袋	装疯（风）
大树做椽子	揭（截）短
大水冲崩关帝（土地）庙	慌了神
大水冲了龙王庙	自家人不识自家人；一家人不认一家人
大水冲了菩萨	绝妙（庙）
大水缸里捞芝麻	难上加难；难上难
大松树作柴烧	大材小用
大蒜剥皮	层层深入
大蒜发芽	多心
大蒜结籽	抱成团
大蒜苗做枕头	昏（荤）头（荤）脑
大铁锤敲钢锣	当当响；响当当
大厅里放盆火	满堂红
大厅中央挂字画	堂堂正正
大头鱼（鳕鱼）背鞍子	跑江湖
大头针包饺子	露馅
大腿上把脉	不对路数；胡来
大腿上长疮	走到哪，坏到哪
大腿上挂篷帆	一路顺风
大腿上挂铜锣	走到哪，响到哪
大腿上画老虎	吓不了哪一个
大腿上贴门神	走了神
大网捕小鱼	劳而无功；有劳无功
大网眼捕鱼	枉费功；白费功夫；白费心
大雾里看天	迷迷糊糊
大雾笼罩山腰	不识真面目
大雾天放鸭子	有去无回
大虾炒鸡爪儿	蜷腿带拱腰（比喻插躬屈膝、低三下四的样子。）
大虾掉进油锅里	闹了个大红脸
大虾米炒鸡爪儿	抽筋带弯腰儿
大下巴吃西瓜	滴水不漏；点滴不漏
大象吃豆芽	不够塞牙缝；不够嚼
大象吃蚊子	无从下口；无法下口；难下
大象逮老鼠	有劲使不上；有力无处使
大象逮跳蚤	有劲使不上
大象的鼻子	能屈能伸
大象的屁股	推不动
大象喝水	有肚量
大象呼吸	双管齐下
大象换老鼠	不上算；不合算
大象身上的跳蚤	微不足道；微乎其微
大象抓凤凰	眼高手低
大象走路	稳重
大象嘴里拔牙	胆子不小；好大的胆子；办不到；别想
大小子撵（nian追赶）鸭子	呱呱叫
大雪落在海里头	看得见，摸不着
大眼瞪小眼	面面相觑（qu看；瞧）
大眼筛子里捉黄鳝	跑的跑，溜的溜
大眼筛子盛米	一个不留
大眼贼（黄鼠）掉到昆明湖	不着边际
大眼贼碰上仓老鼠㈠、老鼠）	大眼瞪小眼
大雁吃莲秆	直脖啦
大雁飞过拔根毛	总要捞一把
大雁飞行	成群结队
大雁跟着飞机跑	落后了
大爷和太爷	只差一点；差一点
大衣柜没把手	抠门儿
大鱼吃小鱼，小鱼吃虾米（小虾）	大的欺负小的；弱肉强食
大鱼吃小鱼，小鱼吃虾米，虾米吃青泥	一物降一物
大鱼嘴边的虾子	跑不了
大雨天打麦子	难收场
大雨天上房	找漏洞
大月光夜里打电筒	多事
大轴和马达	只有一个心眼儿
大轴里套小轴	话（画）里有话（画）
大字写成太	多了一点
大自然的风	来去匆匆
呆女嫁痴汉	谁也不嫌谁
呆子把脉	摸不着
呆子帮厨	越帮越忙
呆子帮忙	越帮越忙（比喻帮了倒忙。）
呆子不识走马灯	来的来，去的去
呆子吃砒霜（pi shuang砷的氧化物。剧毒）	找死；送死
呆子观灯	一片明
呆子哼曲子	没谱
呆子进迷宫	摸不清东南西北
呆子看戏	光图热闹
呆子看烟火	傻了眼
呆子求财	越多越好；多多益善；分不清东
呆子求情	有理说不清；讲不清道理
呆子娶个秃老婆	两将就；两凑合
代别人写情书	不是真心
带刺的铁丝	难缠
带刺的鲜花	好看又扎手
带了秤杆忘了砣	丢三落（la）四
带泥的萝	有点土气
带念珠的老虎	假念弥陀；假慈悲
带素珠的老虎	假念弥陀（比喻假装心善。）
带崽的母老虎	分外凶
带着秤杆买小菜	斤斤计较
带着救生圈出海	有备无患
带着老婆出差	公私兼顾
带着烟不抽	装着玩
待人不分厚薄	一视同仁
袋鼠的本事	会跳
逮了兔子死了鹰	得不偿失
戴草帽亲嘴	差一截子
戴大红花回朝	大功告成
戴斗笠打伞	双保险，多此一举
戴斗笠坐席子	独霸一方
戴碓窝（dui wo石臼）玩狮子	劳而无功；有劳无功
戴耳环画眉毛	耳目一新
戴钢盔爬树	硬着头皮上
戴瓜皮帽穿西服	土洋结合
戴红缨帽上树	红到顶上
戴礼帽的偷书	明白人办糊涂事
戴了笆斗进庙门	想充大头鬼
戴马桶坐大堂	赃（脏）官
戴墨镜上煤堆	一团漆黑
戴上笼头的小毛驴	听人使唤
戴特大帽子穿小鞋	头重脚轻
戴孝帽看戏	乐而忘忧
戴眼镜买车轴	各投各眼；各对各眼
戴着草帽打雨伞	多此一举
戴着斗笠打伞	多此一举
戴着斗笠亲嘴	差着一帽子
戴着碓窝（dui wo石臼）拜年	费力不讨好；吃力不讨好
戴着口罩亲嘴	隔了一层
戴着帽子鞠躬	岂有此理（礼）
戴着帽子亲嘴	差得远
戴着帽子找帽子	糊涂到顶了
戴着面具进棺材	死不要脸
戴着面具亲嘴	没一点情味
戴着面具上街	没脸见人
戴着乌纱弹棉花	有弓（功）之臣
戴着乌纱帽不上朝	养尊处优
戴着孝帽去道喜	自讨没趣
戴着眼镜挑媳妇	看花了眼；花了眼
戴着雨帽进庙门	冒充大头鬼
单车追汽车	望尘莫及
单根青丝拴磨盘	千钧一发
单箭射双雕	上举两得
单口相声	个人说了算
单人唱戏	独角
单身汉分到房	自成一家
单身汉接寡妇	整旧如新
单身汉跑江湖	无牵挂；无牵无挂
单身汉娶媳妇	自作主张
单身碰到和尚	尽光棍；全是光棍
单手举磨盘	独力难撑
单眼挑媳妇	一眼看中
担百斤行百里	任重道远
担沙填海	白费功夫；白费劲
担山填海	力不能及；力不从心；心有余而力不足
担心手臂比腿粗	多余
担着苦瓜喊瓜甜	嘴甜心苦
担着苦瓜乐本	没谱儿了
担着石磨赶庙会	负担太重
担子两头挂红灯	挑明
胆小鬼打仗	临阵脱逃
胆小鬼偷东西	忐忑（tan te心神不定）不安；惴惴（zhui zhui又愁又怕）不安
胆小鬼走夜路	提心吊胆
胆小鬼坐飞机	抖起来了
胆汁拌黄连	苦上加苦
胆汁滴在眉毛上	苦在眼前；眼前苦
掸子没毛	光棍一条
弹弓打飞机	差得远；挨不上
弹花槌擀烙馍	心里厚
弹花店挂弓	不谈（弹）了
弹花匠的女	只会谈（弹）
弹花匠上殿	有功（弓）之臣
弹花铺里打铁	软硬兼施
弹花铺里失火	谈（弹）不成了
弹簧身子蚂蟥腰	能屈能伸
弹棉花的戴乌纱帽	有功（弓）之臣
蛋打鸡飞	两头空；两落空
蛋壳垫桌脚	支撑不住
蛋壳黄都没干	卖啥老哩
蛋壳里做道场	摆不开架势
当婊子竖牌坊	不知差耻
当兵的背算盘	找仗（账）打
当兵的垒灶	安营扎寨
当差放私骆驼	假公营私
当官不坐高板凳	平起平坐
当官丢了印	昏头昏脑；昏了头
当家神（灶神）卖土地	一贫如洗
当了皇帝想成仙	贪得无厌
当了衣裳买粉搽	穷讲究；穷打扮
当面锣，对面鼓	明打明敲
当面是人背后是鬼	阳一套，阴一套
当面诵善佛，背后念死咒	阳奉阴违
当面肃葱	一层一层地摆摆（比喻一件事一件事他说清楚）
当娘的打扮小闺女	人细人微
当铺丢娃娃	把你不当人；拿人不当人
当铺里抛出孩子来	不当人儿（比喻虐待人。）
当头炮	将住罗（比喻给人出难题，使人为难。）
当一天和尚撞一天钟	得过且过
当衣服买酒喝	顾嘴不顾身
当着矬子（个子矮的人。矬，cuo矮）说短话	成心叫人难堪；揭人短
当着阎王告判官	没有好下场
挡风板做锅盖	受了冷气受热气
挡风玻璃当锅盖	明受气
刀把老鼠（小老鼠）	最刁
刀底下的豆腐	任人宰割；随人宰割
刀架心上头	忍吧
刀尖上打拳	站不住脚
刀尖上赌气	活要命
刀尖上翻跟头	不怕死；好危险；冒险；好险
刀尖上翻筋斗	玩命的事（比喻干冒险的事。）
刀尖上立正	站不住脚
刀尖上耍杂技	硬逞能；瞎逞能
刀尖上跳舞	凶多吉少
刀砍大海水	难舍难分
刀马旦不会刀枪	笨蛋（旦）；徒有虚名
刀劈毛竹	迎刃而解；干脆利索；一分为二
刀切酥油	两面光
刀刃上抹鼻涕	难下手；下不了手
刀刃上骑车	不要命的主
刀剜黄连	刻苦
刀下的绵羊	任人宰割；随人宰割
刀削铅笔	要的就是尖
刀子插在鞘里	锋芒不露；不露锋
刀子对斧子	硬对硬
刀子嘴，豆腐心	嘴硬心软
导弹打飞机	同归于尽
导火线上拴炸药	一触即发
倒背手放风筝	扯远了
倒背手看鸡窝	不简单（捡蛋）
倒长的山藤	根子在上头
倒吃甘蔗	节节甜；一节比一节甜
倒吊的腊鸭	一嘴油
倒翻芝麻担	难以收场
倒钩藤子揍娃娃	连拖带打
倒了碾盘砸了磨	实（石）打实（石）
倒了蔬菜盘砸了磨	实（石）打实（石）
倒了五味瓶子	酸甜苦辣咸都有
倒了油瓶不扶	袖手旁观；懒到家了
倒骑毛驴戴呈钓	尽走黑路
倒骑毛驴	往后瞧
倒瓤的冬瓜	一肚子坏水
倒贴的门神	翻（反）脸
倒闲话，落不是	吃了嘴的亏；全坏在嘴上
倒泻一箩蟹	各人手硬各人扒
倒坐炕沿扇扇子	耍风流
捣蒜剥葱	各管一工
捣蒜槌子	独根儿
到饭馆里买葱	未必给你（比喻找错门路，不会达到预期的目的。）
到了山顶想上天	贪得无厌
到派出所领东西	物归原主（比喻失去的东西叉重新得到。）
盗马贼挂佛珠	假正经；假装正经
盗马贼披袈裟	嫁祸于人
盗墓贼作案	捣鬼
道东的献笼套	你道西的插什么嘴
道士吹螺号	吓鬼
道士打醮（da jiao旧时遭士设坛念经做法事）	鬼使神差
道士念经	照本宣科
道士跳法场	装神弄鬼；鬼使神差
道士遭雷打	作法自毙
道士做醮场	鬼使神差
道士的辫子	挽得紧
稻草包黄鳝	溜啦
稻草弹被絮	不是正经胎子
稻草点灯	十有九空
稻草肚子棉花心	虚透了
稻草堆里埋石头	软中有硬
稻草盖珍珠	内中有宝；外贱内贵
稻草秆打人	软弱无力
稻草人放火	害人先害己；惹火烧身
稻草人过河	不成（沉）
稻草人救火	自顾不暇；自身难保；同归于尽；引火烧身；自取灭亡
稻草人救人	自身难保（比喻自己也保不了自己，就更无法保别人了。）
稻草绳子拔河	经不住拉
稻草绳子担石头	两头怕
稻草绳子做裤腰带	尴尬
稻草绳做裤腰带	尴尬
稻场撒网	空捕一场
稻谷场上扬草	撒谎（荒）
稻田里插秧	以退为进；后来居上
稻田里的稗子	你算哪棵苗
稻田里盖猪圈	肥水不流外人田
稻田里干活	拖泥带水
稻田里拉犁耙	拖泥带水
稻子去了皮	白人（仁）儿
得阑尾炎动手术	除恶务尽
得了狂犬病的恶狗	正在风（疯）头上
得了五谷想六谷，有了肉吃嫌豆腐	欲无止境
得了雨衣还要伞	贪得无厌；贪心不足
得陇望蜀	贪心不足
得胜的猫儿	欢似虎
得势的狸猫	欢似虎
得一望十，得十望百	贪得无厌
得鱼丢钩	忘恩负义
德州扒鸡	窝着脖子别着腿
灯草搓绳，烂板搭桥	枉费心机
灯草搭浮桥	走不得
灯草打鼓	不想（响）
灯草打老牛	不痛不痒；无关痛痒
灯草打人	软弱无力
灯草打围墙	一点没事
灯草当秤砣	没份量
灯草抵门	靠不住；不可靠
灯草吊颈	做作
灯草掉在水里头	不成（沉）
灯草赶苍蝇	软收拾
灯草拐棍	飘飘然；难撑；靠不住
灯草拐杖	做不得主（柱）
灯草灰过大秤	没份量
灯草栏杆	靠不住（比喻指望不上，依靠不得）
灯草铺失火	没得救
灯草套牯牛（公牛）	动不得
灯草织布	枉费心机
灯草做琴弦	一谈（弹）就崩；不值一谈（弹）
灯蛾扑火	惹火烧身；引火烧身
灯迹不叫灯迹	“笑面虎”（比喻外貌装得善良而心地凶狠的人）
灯尽油干	玩完
灯笼点蜡烛	心里亮；肚里明
灯笼赶集	白瞪眼
灯笼壳子	肚里空；外头好看里头空
灯笼照火把	亮对亮
灯笼做枕头	承受不起；难撑
灯下点烛	白费蜡
灯心草挑刺	太软
灯心草做琴弦	不值一谈（弹）
灯心上煨牛筋	快不了
灯芯草挑刺	太软
灯芯草做琴弦	不值一谈（弹）
灯影戏（皮影戏）里想媳妇	一白遮百丑
灯影子（灯影人）打店	人旺财不旺
灯影子上饭馆	人多不吃食
灯影子作揖	下毒（独）手
灯盏里洗澡	不晓得大小
灯盏无油	空费心；白费心；光费心
登上山顶望平地	回头见高低
登上泰山望东海	站得高，看得远；登高望远
登上泰山想升天	好高骛远
登台前的演员	涂脂抹粉
登太行望运河	远水不解近渴
登着软梯子上飞机	扶摇直上
登着梯子说话	高攀；想高攀
等公鸡下蛋	没指望
等天上掉馅饼	坐享其成
凳子翻个儿	四脚朝天
凳子上抹狗屎	坐不得
凳子上抹石灰	白挨
瞪着眼睛咬牙	怀恨在心
瞪着眼睛咬着牙	怀恨在心
低头婆娘仰头汉	最难斗
羝羊（di yang公羊）触藩（fan篱笆）	进退两难
滴水穿石	非一日之功
滴水崖上滴水	没完没了
敌敌畏拌大蒜	又毒又辣；毒辣
笛子吹火	到处泄气
笛子独奏	自吹
笛子没眼	吹不响
笛子配唢呐	想（响）得不一样
笛子配铜锣	想（响）到一块了
抵门杠当针使	大材小用
抵门杠做牙签	大材小用
地板擦子刷地	拖泥带水
地道里卖门神	看出来的好活（画）儿
地洞里藏老鼠	见不得阳光
地府里打官司	死对头
地府里打冤家	鬼打鬼
地黄瓜丢架子	嫁（架）不得
地窖里打灯笼	来明的
地老鼠跑江南	走路不多，见天不多
地里的萝卜	上清（青）下不清（青）
地里的蚯蚓	土生土长；能屈能伸；成不了龙
地里的蛐蟮	成不了龙
地里的庄稼	土生土长
地面上的水	哪里低往哪里流
地球安把	没法提；提不得；提不起来；别提了；大梨一个
地球绕着太阳转	周而复始
地上的蚂蚁	数不清
地上的野草	除不尽
地上的影子	你走他也走
地上的砖头	踢一踢，动一动
地上拣起来的饼	不干不净
地上跳到席上	不足为奇
地上栽电杆	正直
地摊上卖书（放书）	没架子
地毯上寻针	吹毛求疵（刺）
地头蛇，母老虎	不是好惹的
地头蛇请客	福祸莫测
地图上画个圈	谁知道有多大
地下流出来的水	来路不明
地狱里碰见救命菩萨	死里求生
地主老爷的碗	难端
弟兄俩分家	单干；另起炉灶
第六个手指	多余
掂着算盘上门	找人算账
掂着猪下水（可食的猪内脏）过独木桥	提心吊胆
点了黄豆不出苗	孬（nao坏；不好）种；不是好种
点起火把作战	来明的
点燃的蜡烛	长命（明）不了
点着火的双响	气得嘣八丈高
踮着脚尖儿立正	不长久
电灯泡上点火	不然（燃）；其实不然（燃）
电灯照鹿头	名（明）角
电灯照墙角	名（明）角
电灯照雪	明明白白；明白
电饭锅做饭	不要火
电风扇的脑袋	专吹冷风；吹冷风
电杆做牙签	大材小用
电焊的火花	看不得
电话拜年	两头方便
电话断了线	说不通
电话里谈恋爱	两不见面
电锯开木头	当机立断
电扇吹鱼网	漏风
电扇上伸双手	吹捧
电视广告上的美人	昙花一现
电视机里放录音机	多响了一层
电视上的画面	说变就变
电梯失灵	上下两难；上下为难；上不上，下不下
电线杆穿大褂	细高挑儿（身材细长的人）
电线杆当筷子	没法下嘴
电线杆当套马杆	用材不当
电线杆顶上雕花	手艺高
电线杆挂灯笼	有名（明）的光棍；高明
电线杆上安喇叭	想（响）得高
电线杆上绑鸡毛	胆（掸）子不小；好大的胆（掸）子
电线杆上插土豆	大小是个头
电线杆上吊暖壶	高水平（瓶）；水平（瓶）高
电线杆上拉胡琴	大老粗
电线杆上晒衣服	架子不小；好大的架子
电线杆上耍把势	艺高胆大；武艺高；本领高；险得很
电线杆上耍把戏	闹玄
电线杆子挂暖壶	水平（瓶）高
电线杆子剔牙	太粗
电线杆做牙签	进不了口
电线上的风筝	缠上了
电信局里的话务员	耳听八方
电影里的夫妻	假的
电影里放电视	戏中有戏
电影里谈恋爱	假情假意；假仁假义
电子显微镜	明察秋毫
电钻钻孔	硬要打通；不通也要通
店铺里的蚊子	吃客
店铺前吊门板	好大的牌子
垫着被盖睡觉	高枕无忧
靛蓝染白布	一物降一物
刁鹰飞人鸡场	没个好心肠
叼羊游戏中的小羊羔	任人撕扯
叼着喇叭敲鼓	自吹自擂
貂婵嫁吕布	英雄难过美人关
雕花店里失火	刻不容缓
雕花师傅戴眼镜	精雕细刻
雕塑匠手里的泥巴	随人捏；随心所欲
吊颈鬼脱裤子	又不要脸，又不要命
吊起的冬瓜	头重脚轻
吊起锅儿当钟打	穷得丁当响
吊扇下面拉家常	讲风凉话
吊死鬼擦粉	死要面子
吊死鬼搽粉	死要面子；死要脸
吊死鬼打眼角（做媚眼调情）	死不要脸
吊死鬼戴花	死要面子；死要脸
吊死鬼当婊子	死不要脸
吊死鬼的裹脚布	死臭
吊死鬼瞪眼	死不瞑目
吊死鬼流眼泪	死得屈
吊死鬼上银行	死要钱
吊死鬼耍大刀	死得屈来闹得凶
吊死鬼讨账	活该
吊死鬼照镜子	自己吓唬自己
吊桶落在井里	不上不下；上不上，下不下
吊桶脱箍	没法提；提不得
吊在房梁上的葱头	皮焦根枯心不死；叶烂皮干心不死
吊在房檐上的大葱	叶黄皮干心不死（比喻敌人不甘心失败，妄想作垂死挣扎。）
吊着头发打秋千	不要命；玩命干
钓鱼钩变成针	以屈求伸
掉光头发甩木梳	可以理解
掉进草窝的绣花针	没处寻；难寻
掉进浆糊盆里的苍蝇	拔不出腿来
掉进开水锅里虾	急红了眼
掉进麦芒堆里	混身不自在
掉进水里的鼓	打不响
掉进陷阱里的狗熊	熊到底了
掉进陷阱里的野猪	张牙舞爪；死路一条
掉了耳朵的瓦罐	提不起来；没法提；提不得
掉了箍的水桶	散了板
掉了几根毫毛	无伤大体
掉了帽子喊鞋	头上一句，脚下一句
掉门牙肚里咽	有苦说不出；有苦难诉
掉下井的秤砣	扶（浮）不上来
掉在井里打扑登	死不死，活不活
掉在枯井里的牛犊	有劲使不上；有力无处使
掉在油缸里的老鼠	滑头滑脑
爹爹给婆婆拜年	多此一举
爹死哭娘	犟种一个
爹死娘嫁人	各人顾各人
跌倒还要抓把沙	不落空
跌到车道沟里喊救命	吓得不知深浅
跌翻鸟窝砸碎蛋	倾家荡产
跌跟头捡金条	运气好
跌进糨糊盆的娃娃	糊涂人
跌进米坛的耗子	好景不长
碟子里的豆芽菜	开不了花，结不了果（比喻最终没有收获。）
碟子里的开水	三分钟的热劲
碟子里面扎猛子	不知深浅
碟子里生豆芽	难生根；扎不下根
碟子里盛清水	眼看到底
碟子里栽牡丹	根底浅
碟子里扎猛子	不知深浅
碟子装水	太浅
丁丁猫（蜻蜒）咬尾巴	自害自
丁丁猫挖眼睛	不要脸
钉钉子捶了手	敲不到点子上
钉锅碗打坏金刚钻	蚀本生意
钉木鞋使锥	多余
钉耙戴斗笠	尖上拔尖
钉是钉，铆是铆	不含糊
钉掌的敲耳朵	离题（蹄）太远；不贴题（蹄）
钉子锈在木头里	铁定了
顶大风过独木桥	担风险
顶风撑船	划不来；上劲
顶风顶浪上水船	力争上游
顶风放屁	自己臭自己；自臭自
顶风扬帆	不辨风向
顶礼膜拜的小人	一副奴才相
顶门杠做牙签	大材小用；难插嘴；插不上嘴
顶石头上山	多此一举
顶着被子玩火	惹火烧身；引火烧身
顶着碾盘唱戏	自讨苦吃
顶着笸箩（po luo盛谷物等的器具。用柳条或篾条等编成）望天	视而不见
顶着石臼做戏	费劲不落好；费力不讨好；吃力不讨好。
鼎锅做帽子	难顶难撑
定航的班机	继往开来
腚（ding臂部）上吊沙罐	等死（屎）
丢金碗捡木勺	得不偿失
丢了秤砣捡灯草	避重就轻
丢了东西打瞎子算卦	闹了个白瞪眼
丢了黄牛撵（nian追赶）蚊子	因小失大
丢了黄牛撵兔子	不知哪大哪小
丢了铁锤担灯草	拈轻怕重
丢了西瓜拣乏麻	因小失大
丢了西瓜捡芝麻	大处不算小处算；不知大小；得不偿失
丢了媳妇又赔房	人财两空
丢了羊群捡羊毛	大处不算小处算
丢了一枚绣花针	小事一桩
丢了一只羊，捡到一头牛	吃小亏占大便宜
丢下黄羊撵（nian追赶）兔子	不知哪大哪小
丢下犁耙拿扫帚	里里外外一把手
丢下灶王拜山神	舍近求远
东北的二人转	一唱一和
东边日出西边雨	各有天地
东扯葫芦西扯瓢	胡拉乱扯
东待发货西待卖	不图赚钱只图快
东方打雷西方雨	声东击西
东方天亮下大雪	明明白白；明白
东放一枪，西打一棒	声东击西
东郭先生救狼	自找苦吃；好心不得好报；姑息养奸；善恶不分
东家（受人雇用或聘请的人称他的主人）的饭碗	难端
东家的饭碗	难端
东家起火，西家冒烟	一波未平，一波又起
东街发货西街卖	不图赚钱只图快
东篱补西壁	顾此失彼
东山跑过驴，西山打过虎	见过点阵势
东头拜堂，西头出丧	唱对台戏
东吴杀人	嫁祸于人
东吴招亲	上当一回；弄假成真
东西耳朵南北听	横竖听不进
东西路南北拐	走邪（斜）道
东园桃树西园柳	好不到一块儿
东岳庙的二胡	鬼扯
东岳庙走到城隍庙	处处有鬼
冬瓜熬清汤	乏味
冬瓜肚里生蛆	一副坏心肠
冬瓜皮做帽子	滑头；滑头滑脑
冬瓜皮做甑子（zeng zi蒸米饭等的用具）	不争（蒸）气
冬瓜钱算在葫芦上	混账
冬瓜上霜	两头光
冬瓜淌水	坏透了
冬瓜藤缠到茄子地	拉拉扯扯
冬瓜下山	滚了
冬水田里种麦子	怪哉（栽）
冬天不戴帽子	动（冻）脑筋
冬天吃梅子	寒酸
冬天吃葡萄	寒酸
冬天穿汗衫	冷暖自己知
冬天的大葱	皮干叶烂心不死
冬天的炉子	闲不着
冬天的蚂蚁	不露头
冬天的蟒蛇	有气无力
冬天的暖水瓶	外冷内热
冬天的螃蟹	横行不了几时
冬天的青蛙	躲起来啦
冬天的扇子，夏天的火炉	没人爱
冬天的扇子	没用处；尽受冷落
冬天的旋风	成不了气候
冬天的竹笋	出不了头
冬天贩冰棒	不懂买卖经；不识时务
冬天火炉夏天扇	个个喜爱
冬天进豆腐房	好大的气
冬天买扇子	备用
冬天卖醋	寒酸
冬天卖凉粉	不识时务
冬天卖扇子	过时货
冬天泡桐树	光棍一条
冬天摇蒲扇	不知春秋
董存瑞炸碉堡	视死如归
董卓进京	来者不善
董卓戏貂蝉	死在花下
动物园里的长颈鹿	身高气傲
动物园里的饲养员	习惯与兽类打交道了
动物园里找猪圈	自找难看
冻豆腐	难办（拌）
冻僵的长虫（蛇）	要死不活；死不死，活不活
洞宾戏牡丹	两厢情愿
洞房里换孝衫	又喜又悲；悲喜交加
洞房里说悄悄话	甜言蜜语
洞里的蛇	不知长短
洞里的乌龟	不怕惊
洞门边捉黄鳝	出来就抓
洞庭湖吹喇叭	想（响）得宽
洞庭湖里的麻雀	见过风浪；好大的胆子
洞庭湖里的鸭子	无人管
洞庭湖里捞针	想得到，办不到；白日做梦
洞庭湖里漂根草	渺小
洞庭湖里涨春水	一浪高一浪
洞庭湖上踩钢丝	凶多吉少
兜里的钱，锅里的肉	跑不了
斗败的公鸡	垂头丧气；有气无力；少气无力
斗大的馒头	无处下口；难开口
斗大的线团子	难缠
斗鸡上阵	横眉竖眼；劲头十足
斗笠出烟	冒（帽）火
斗笠穿孔	出头之日到了
斗篷烂边	顶好
斗输的公鸡	耷拉（da la下垂）着脑袋
斗赢了的公鸡	神气十足；神气活现
豆饼干部	上挤下压
豆饼做豆腐	有点粗
豆豉（chi）口袋	肮脏货；臭货
豆腐白菜	各有所爱
豆腐板上下象棋	无路可走
豆腐拌腐乳	越弄越糊涂；越搞越糊涂
豆腐场里的石磨	道道多（比喻主意、办法多。）
豆腐炒韭菜	清清白白；一清（青）二白
豆腐打地基	根基太软；底子软
豆腐打根基	底子软
豆腐挡刀	自不量力；招架不住
豆腐店的买卖	软货
豆腐店开在河边上	水里来，水里去
豆腐店里的把式	靠压
豆腐店里的东西	不堪一击
豆腐店里做豆腐	靠压
豆腐垫床脚	白挨
豆腐垫鞋底	一踏就烂
豆腐掉灰堆	洗不净；吹也吹不得，拍也拍不得
豆腐掉进灰堆里	吹又不好吹，打又不好打（比喻事情没有法办）
豆腐钉鞋掌	不是这块料
豆腐堆里一块铁	有软有硬
豆腐炖骨头	有软有硬
豆腐坊掉磨子	推不得；没法推；没得推啦
豆腐干煎腊肉	有言（盐）在先
豆腐架子	碰不得；不牢
豆腐佬摔担子	倾家荡产
豆腐垒基脚	底子软
豆腐里捡骨头	无中寻有；故挑剔；枉费工；没事找事；故意找茬儿
豆腐里挽米汤	糊里糊涂；糊糊涂涂；
豆腐脑儿洒地上	难收拾；不可收拾
豆腐脑儿摔地上	一塌糊涂
豆腐脑儿挑子	两头热
豆腐盘成肉价钱	不合算；划不来
豆腐身子	经不起摔打
豆腐饨骨头	不软不硬
豆腐行卖磨	没法推
豆腐渣包饺子	捏不拢；用错了馅
豆腐渣擦屁股	没完没了
豆腐渣炒耦片	迷（弥）了眼
豆腐渣垫地基	底子软
豆腐渣糊门	不沾（粘）板
豆腐渣糊墙	巴结不上；两不沾（粘）
豆腐渣烙饼	和不到一块；和不起来
豆腐渣上秤盘	不是好东西；不是不是好货
豆腐渣上船	装贱；不值钱的货，
豆腐渣上坟	骗鬼；哄鬼；哄列人
豆腐渣贴对联	白费工夫巴结不；两不沾（粘）
豆腐渣贴门神	不沾（粘）
豆腐渣下水	散了
豆腐渣蒸馒头	散了
豆腐渣子上船	不是货（比喻不是像样的东西。）
豆腐坐班房	平白无故
豆腐做匕首	软刀子
豆腐做门墩	难负重任
豆鼓悯豆腐	黑白分明
豆荚抽筋	两头受气；两头受制
豆芽拌粉条	里勾外连；内外勾结
豆芽包饺子	内中有弯
豆芽不叫豆芽	窝脖货
豆芽炒鸡毛	乱七八糟
豆芽炒韭菜	各有所爱；各人所爱
豆芽炒虾米（小虾）	两不值（直）；低头的低头，弯腰的弯腰
豆芽的一生	总受压
豆芽儿拦粉条	里勾外连
豆芽子上天	带悔尾巴的能豆儿
豆渣撒在灰堆上	难收拾；不可收拾
逗猫惹狗	无事生非
逗哑巴挨口水	自找没趣
窦娥（《窦娥冤》中的人物）的冤魂	不散
窦娥喊冤	怨天怨地
毒蛇出洞	伺机伤人
毒蛇的舌头	独（霉）分乙（芯）裁
毒蛇的牙齿马蜂针	最毒；全是毒
毒蛇见硫磺	浑身酥软
毒蛇爬竹竿	又狡（绞）又猾（滑）
毒蛇吐芯子	出口伤人
毒蛇牙齿马蜂针	毒极了；最毒
毒蛇钻进竹筒里	假装正直
毒蛇做梦吞大象	野心勃勃；野心太大
毒蜘蛛织网	碰不得
犊子踢牛婆（母牛）	恩将仇报；以怨报德
独膀子打拳	露一手
独臂将军亮相	露一手
独臂将军	有一手；一把手
独臂照镜子	里里外外一把手
独臂做饺子	一手包办
独根灯草点灯	只有一个心眼
独根蜡烛	无二心
独根头发系磨盘	千钧一发
独脚蟹	爬不快
独轮车散了架	没法推了；推不得
独木桥	难过
独木桥上踩车	别拐弯
独木桥上钉木板	故意让人过不去
独木桥上扛木头	难回头
独木桥上跑马	冒险；危险
独木桥上散步	走险
独木桥上睡觉	翻不了身
独木桥上遇仇人	冤家路窄；分外眼红
独眼看戏	一目了然
独眼龙观灯	一目了然
独眼龙看告示	睁只眼，闭只眼
独眼龙相女婿	一目了然
堵八戒爬墙头	倒打一耙
堵八戒散伙	不：于了
堵八戒十八变	没有一副好嘴脸
堵塞的烟囱	憋气又窝火
堵往笼子捉鸡	一个也跑不了
堵住笼子抓鸡	稳拿
赌场里的赌棍	孤注一掷
赌场掷骰子（tou zi）	吆五喝六
赌徒的嘴巴	尽说到点子上
赌徒手里的钱	留不住；难久留
睹八戒耍大刀	不顺手
杜十娘的百宝箱	全部家当在里头
杜十娘的箱中物	件件是宝
杜十娘怒沉百宝箱	人财两空
肚饥送来白面馍	正合适
肚里长瘤子	心腹之患
肚里长牙齿	心里狠
肚里吃了鞋帮	心里有底
肚里的孩子自己生	谁也代替不了
肚里开飞机	内行（航）
肚里容不得一根毛	心胸太小
肚里吞金	有内才（财）；心里沉重；心里负担太重
肚里装公章	心心相印
肚里钻进二十五只小耗子	百爪挠心
肚皮里点灯	心里明白
肚皮里安电灯	心里亮，肚里明
肚皮里吃了萤火虫	全明了（比喻心里清楚。）
肚皮上割肉打牙祭（偶尔吃一顿丰盛的饭）	干不得
肚皮上磨刀	冒险；危险；好险
肚皮上贴膏药	心腹之患
肚皮贴在脊梁上	妖（腰）气
肚脐眼安雷管	心惊肉跳
肚脐眼巴膏药	贴心；没病找病
肚脐眼插钥匙	开心
肚脐眼长茄子	多心
肚脐眼长笋子	胸有成竹
肚脐眼打电话	心腹之言
肚脐眼里藏书	满腹经文
肚脐眼里插冰捧	寒心
肚脐眼里点眼药	心里有病
肚脐眼里灌醋	心酸得很
肚脐眼里灌汤药	心服口不服
肚脐眼里生疮	坏透了
肚脐眼上挂钥匙	开味（胃）
肚脐眼说话	谣言（腰言）
肚痛点眼药	无济无事
肚痛埋怨帽子单	错怪
肚子饿赶上吃晌午（午饭）	正合心意
肚子里长草	闹饥荒
肚子里长笋	胸有成竹
肚子里撑船	内行（航）
肚子里揣漏勺	心眼大多
肚子里打灯笼	自己心里明白
肚子里的蛔虫	（贿qing享受）吃喝
肚子里磨刀	内秀（锈）；秀（锈）气在内
肚子里敲小鼓	心里扑腾
肚子里吞擀面杖	直肠子；直肠直肚
肚子里行船	内行（航）
肚子里有半斤，嘴上倒五两	有一句说一句；有啥说啥
肚子痛搽红药水	不起作用
肚子痛上眼药	点不到痛处
渡船过河	划得来
渡口上打转身	想不过
镀金的佛像	华而不实
端别人的碗	服别人管
端公（巫师）吹牛角，道士吹海螺	各师各教
端公打令牌	吓鬼
端公打坐	装神弄鬼
端金碗讨饭	装穷
端起刀头（祭神鬼用的熟肉）上庵堂	自找没趣
端水缸救火	费力不小，收获不大
端午节拜年	不是时候
端午节包粽子	有棱有角
端午节吃饺子	与众不同
端午节吃粽子	皆大欢喜
端午节后布谷叫	过时啦（比喻迟了。）
端午节划龙舟	载歌载舞
端午节卖历书	过时货
端着鸡蛋过独木桥	提心吊胆
端着糨糊上天	胡（糊）云
端着金碗讨饭	装穷叫苦（比喻本来很富裕，故意装穷。）
短板子搭桥	不顶用；不顶事
短的当棒槌，长的做房梁	各有一技之长
短棍儿打蛇	难近身；近不得身
短裤着短袜	高攀不上；差一截子；够不着
短木搭桥	难到岸
断臂的猴子	高攀不起
断柄锄头安了把	有把柄可抓
断柄锄头	没有把握
断根的香椿	难发芽
断了背的椅子	靠不住；不可靠
断了柄锄头安了把	有了把柄
断了翅膀的苍蝇	嗡嗡不了几天
断了翅膀的凤凰	神气不了
断了翅膀的鸟	飞不高
断了翅膀的野鸡	飞不了
断了发条的钟	不走了
断了脊梁骨的癞皮狗	没有骨气
断了气的奶娃娃	给谁谁不要
断了腿的蛤蟆	蹦不了几天；没几天蹦头
断了腿的螃蟹	跑不了
断了腿的青蛙	跑不了（比喻某项任务或某件事情很保险，很有把握。）
断了腿的蚱蜢	没几天蹦头；蹦鞑不了几天
断了弦的二胡	不想（响）
断了弦的提琴	没了响声
断了线的风筝	远走高飞；上不着天，下不着地；满天飞；身不由己；无牵无挂；下落不明；由它去；一去不复返
断了线的梭子	白钻空子
断了线的纸鸢	东游西荡
断了线的珠子	七零八落
断了一青	还留有一手
断了轴的手推车	不走了
断藤的西瓜	满地乱滚
断头的苍蝇	乱闯乱碰
断尾巴蜻蜓	有头无尾；一去永不来
断线的喇叭	不声不响；无声无息
断线的木偶	拉不动
断秧的苦瓜	耷拉（da ln下垂）着脑袋
缎子被面麻布里	表里不一
锻工的榔头	趁热打铁
锻磨的去打铁	不识火色；看不出火候来；不会看火色
对岸上的公公	与我无关；与己无关
对镜子打躬	自尊自敬
对镜子作揖	自己恭维自己
对空撒灰	害人先害自己
对空射击	热火朝天
对聋子说话	在张嘴
对门吹笛子	斗气
对门缝吹号	名（鸣）声在外
对牛弹琴	不入耳，难入耳；充耳不闻；白费劲；枉费工
对牛吟诗	不入耳；难入耳
对天讲话	空话连篇；空谈
对哑巴说话	白费口舌
对阵下棋	纸上谈兵
对着靶子射箭	有的放矢
对着穿衣镜作揖	自我崇拜
对着棺材撒谎	哄鬼；骗鬼；哄死人
对着棺材撒尿	欺侮死人
对着棺材许愿	哄死人
对着罐子吹喇叭	有原因（回音）
对着锅底亲嘴	触一鼻子灰；碰一鼻子灰
对着镜子扮鬼脸	自己丑化自己
对着镜子瞪眼	只恨自己
对着镜子发脾气	自己跟自己过不去
对着镜子挥拳头	自己吓自己
对着镜子讲假话	自己骗自己
对着镜子看	里里外外都是自己
对着镜子怒吼	自暴自弃（气）
对着镜子亲嘴	自爱；自欺欺人；自己哄自己
对着镜子伸拳头	自己吓唬自己
对着镜子伸小指	自己瞧不起自己
对着镜子竖拇指	自己夸自己；自以为了不起
对着镜子说漂亮	自夸
对着镜子行大礼	自尊自敬
对着镜子演奏	自吹自擂
对着镜子作戏	咋好看咋比划
对着聋子打鼓	充耳不闻
对着牛嘴打喷嚏（pen ti）	吹牛
对着墙壁流泪	独自悲伤
对着墙壁流眼泪	独自悲伤
对着墙壁踢足球	有去必有回
对着墙壁走路	没门儿；无门
对着桑树骂槐树	指桑骂槐
对着水缸吹喇叭	有原因（圆音）
对着王八批乌龟	正对号
对着瞎子打俏眼	白费劲；枉费工；白费工夫
对着烟囱喊叫	说直话
对着砚台梳头	没影的事
对着月亮攀谈	空话连篇
对着张飞骂刘备	寻着惹气
对着赵云摔阿斗	收买人心
碓杵（dui chu在石臼里捣米用的棒）脑袋	老实疙瘩
碓窝（dui wo石臼）当帽戴	难顶难撑
碓窝里舂夜叉	捣鬼
碓窝里放鸡蛋	求稳
碓窝里栽葱	根子硬
碓窝吞下肚	实（石）心眼
蹲在厕所写八股文	臭秀才
蹲在茅坑问香臭	明知故问
蹲在皮球里过日子	受尽窝囊气
囤顶插旗杆	尖上拔尖
囤子顶上插旗杆	尖上拔尖
炖熟的猪头	难看
钝刀切肉	不快
钝刀子割草	拉倒
钝刀子割肉	靠的手功；不出血；不利索
钝刀子砍豆腐	拣软的欺
钝刀子切豆腐	凑合使用
钝刀子切藕	藕断丝连
钝刀子杀鸡	靠手劲
钝刀子杀猪	全靠手劲
钝刀子斩乱麻	三长两短
钝镰刀割麦	拉倒
多臂观音	到处伸手
多年的陈账	翻不得
多年的寡妇	老手（守）
多年的朋友	老交情
多年的师傅	老把势
垛泥匠不拜佛	心里有底
垛塑匠不敬泥菩萨	谁不知道谁
躲鬼进了城隍庙	出生入死
躲过棒槌挨榔头	祸不单行；躲了一灾又一灾
躲过了老虎，又撞上了野牛	一个比一个凶（比喻灾祸一个比一个严重。）
躲过野牛碰上虎	一个更比一个凶
躲了雷公，遭了霹雳	躲了一灾又一灾；祸不单行
躲雨躲到城隍庙	尽见鬼
躲在屋里洗脏衬衣	家丑不可外扬
剁了脚的螃蟹	横行不了几天
剁肉的墩子	任人砍
峨眉内功林拳	练出来的
峨眉山的猴子	机灵得很
峨眉山上的佛光	看得见，摸不着；可望而不可及
峨眉山上的泉水	细水长流
鹅吃草，鸭吃谷	各人享各人福
鹅蛋换鸭蛋	不上算；不合算
鹅蛋石跌进刺蓬里	无牵无挂（比喻没有挂念之处。）
鹅卵石掉酱缸	一个糊涂蛋
鹅卵石垒墙脚	根基不稳
鹅盆里不准鸭插嘴	独食独吞
鹅上台阶	靠猛劲
鹅伸脖子	等着挨刀
鹅食盆不许鸭插嘴	吃独食
鹅行鸭步	大摇大摆；磨磨蹭蹭
鹅在水中寻食	尾巴翘上天
额头角上搁扁担	头挑
额头上插牡丹	忍痛图好看
恶狗看见棍棒	又恨又怕
恶狗咬天	狂妄（汪）
恶鬼见钟旭	不得不老实
恶虎斗狼群	寡不敌众
恶狼扒门	不祥之兆
恶狼吃天	难下爪
恶狼对羊笑	不怀好意
恶狼和疯狗作伴	脾气相投
恶狼和疯狗做伴	坏到一块了
恶狼落陷阱	作恶到头了
恶狼生个贼狐狸	不是好种
恶狼学狗叫	没怀好意
恶狼专咬瘸腿猪	以强凌弱
恶狼装羊	不存好心；居心不良
恶老雕吃死耗子	对口味
恶老雕戴皮帽	假充鹰
恶老婆告状	有理说不清；讲不清道理
恶老婆骂街	四邻不安
恶魔对丑怪	一对坏
恶婆婆的媳妇	难当
恶人登门	送福
恶人先告状	反咬一口
恶人遇恶人	坏到一块了
饿肚的鸭子	穷呱呱
饿肚汉打冤家	借机（饥）闹事
饿肚汉嗑瓜子	不过瘾；解不了馋；吃不饱肚子；饱不了人
饿肚汉啃鸡爪	解不了馋
饿狗等骨头	垂涎三尺
饿狗抢食	一哄而上
饿狗舔盘子	一干二净
饿狗下茅房（厕所）	找死（屎）；饱餐一顿
饿汉抱着胖刺猥	抱着嫌扎手，丢又舍不得
饿汉啃鸡头	卡壳了
饿汉梦中吃馅饼	妄想；痴心妄想
饿汉抢猪头	争嘴吃
饿汉下馆子	大吃大喝
饿虎进宅	四邻不安
饿狼吃羊羔	生吞活剥
饿狼窜进羊厩（jiu）	无事不来；想饱口福
饿狼口里夺脆骨	好大的胆
饿狼扑兔子	抓住不放
饿狼吞食	一副贪相
饿狼嘴里夺脆骨	好大胆；好大的胆子；胆子不小
饿猫不吃死耗子	假斯文
饿死鬼要账	活该
饿鹰不吃小鸡	冒充斯文
饿猪占木槽	死不放
饿着肚子辩论	空对空
饿着肚子出差	空跑一趟
饿着肚子造反	借机（饥）闹事
饿着肚子做梦	空想
鳄鱼挂念珠	冒充善人
鳄鱼流眼泪	可怜不得；假慈悲
鳄鱼上岸	来者不善
儿看见娘丑	难开口；不好开口；口难开
儿女敬老人	人情人理
儿牵父须过马路	谦虚（牵须）
儿媳妇骂公爹	泼妇
儿子不养娘	白疼一场
儿子成亲父做寿	好事成双
儿子打老子	情理难容；无法无天；岂有此理
儿子给爹抹胭指	要老子的好看
儿子看婆媳吵架	两头为难；两难
儿子娶妻女嫁人	大事完毕
儿子死了娘	说来话长
耳朵长在膝盖上	懒得听
耳朵里抹石灰	白听
耳朵里塞棉花	装样（羊）
耳朵漏风	听不进
耳朵塞驴毛	说不通；听不见；装聋
耳朵塞棉花	装聋作哑
耳朵塞套子	装聋
耳朵上挂板子	打听打听；打听
耳朵眼里灌稀饭	混淆视听
耳朵眼里下棋	摆不开阵势
耳后的疙瘩	无人理会
耳聋鼻塞嘴哑	一窍不通
二八月的天气	忽冷忽热；冷热无常
二八月的庄稼	青黄不接
二八自行车	架子不小；好大的架子
二百加五十	二百五
二百五上天	痴心妄想；妄想
二不愣（二愣子）当家	出不了好主意
二不愣当家	出不了好主意
二尺布做裤衩	两头顾不上
二尺长的吹火筒	只有一个心眼
二齿钉耙锄地	有两下子
二齿钩子挠痒	一把硬手；是把硬手
二大娘抱秃娃娃	旁人不夸自己夸；人家不夸自己夸
二大娘的裹脚布	龌龊（wo chuo不干净）货；又臭又长
二大娘的鞋套子	提不得；提不起来；别提了
二大娘的针线筐	乱七八糟
二分钱的醋	又酸又贱
二分钱开当铺	周转不开
二姑娘裁尿布	闲时预备忙时用
二姑娘的包袱	窝窝囊囊
二姑娘的针线包	花色多
二姑娘架老鹰	招架不住
二姑娘上轿	忸忸怩怩
二姑娘绣荷包	细功夫
二胡拉出笛子调	弦外之音
二虎相争	必有一伤
二黄转中板	变调了
二加三减五	等于零
二郎神出战	尽是天兵天将
二郎神吹笛子	神吹
二郎神的法术	变化多端
二郎神的钢叉	两面三刀
二郎神的慧眼	有远见
二郎神的天犬	恶狗一条
二郎神的印堂	独具只眼
二郎神斗孙悟空	以变应变；你变我也变
二郎神缝皮袄	神聊（缭）
二郎爷的笛子	神吹
二郎爷放屁	神气
二愣子报丧	慌里慌张
二愣子缠线团	越缠越乱
二愣子炒菜	不是滋味
二愣子当演员	胡闹台
二愣子拉胡琴	自顾自（吱咕吱）
二愣子骑老虎背	早晚有他的好看
二愣子上擂台	寻着挨揍
二愣子睡凉炕	全凭火力旺
二愣子抓吃烂芝麻	满肚子坏点子
二愣子做活路	猛一阵
二两米熬锅粥	不愁（稠）
二两棉花	弹（谈）不上
二两铁打把刀	不够分量
二两铁打大刀	不够料
二两银子铸个土地爷	钱能通神
二流子打鼓	吊儿郎当
二流子骂街	胡言乱语；胡说八道
二流子学徒	混日子
二三四五六七八九	缺衣（一）少食（十）
二十七文钱分三份	久闻（九文）
二十钱一双乌拉（wu la东北地区冬天穿的鞋。用皮革制在，里面垫乌拉草）	贱皮子
二十四磅榔头敲钢板	响当当；当当响
二十四天不出鸡	坏蛋
二十岁长胡子	少年老成
二十岁当博士	初露头角
二十五斤四百两（旧制一斤十六两）	没错；错不了
二十五只老鼠咬死人	百爪挠心
二十一天不出鸡	坏蛋
二十一天孵不出鸡	坏蛋
二十只耗子拉犁	乱了套；乱套了
二四六八十	无独有偶
二踢脚（双响爆竹）上天	空想（响）
二踢脚的爆竹	一声更比一声响
二万五千里长征	任重道远
二下五去一	错打了算盘
二小子不拉纤	顺水推舟
二小做梦娶媳妇	白高兴一场
二心的夫妻	迟早要散；同床异梦
二一添作五	一半对一半；平分
二月的菜薹	起了心；另有心
二月的韭菜	头一茬
二月的闷雷	想（响）得早
二月二穿单衣	为时过早
二月去了八月来	不冷不热；热不着也凉不着
发菜炒豆芽	纠缠不清
发臭的酸奶子	坏透了
发大水出丧	天灾人祸
发高烧不出汗	胡说（比喻没有根据地乱说。）
发洪水放木排	赶潮流
发酵池里的高梁	醋性大作
发酵的面粉	气鼓气胀；气鼓鼓
发救兵还择吉日	迟了；晚了
发困给个枕头	正得劲儿（比喻正合心意。）
发了疯的猴子	上蹿下跳
发了霉的葡萄	一肚子坏水
发霉的炒黄豆	不香
发霉的花生	不是好人（仁）
发面馒头送闺女	实心实意
发疟疾吃奎宁（治疟疾的特效药）	对症下药
发丧娶媳妇	悲喜交加；又悲又喜
发射出去的火箭	扶摇直上
发射卫星上天	一鸣惊人
乏驴子上磨	无精打采
伐木拉大锯	你有来，我有去
法场的麻雀	耐惊受怕；胆子早吓大了
法场上的刽子手	杀人不眨眼
法儿他妈哭法儿	没法儿
法官坐班房	知法犯法；明知故犯
法门寺里的贾桂	站惯了的
番（外国）鬼佬耍西洋镜	名堂多
番瓜（南瓜）秧牵上葡萄树	胡搅蛮缠
番薯（甘薯）脑壳檀木心	不灵通
翻穿皮袄	出洋（羊）相；装相（羊）
翻船抓到救生圈	绝处逢生
翻过来的面袋子	空了；空的
翻了篓的螃蟹	到处横行
翻起麻枯打油	没事找事
翻砂工干活	装样子；装模作样
翻身的王八	四脚朝天
凡士林涂嘴巴	油腔滑调
反贴门神	不对脸；左右为难
反转葫芦，倒转蒲扇	出尔反尔
返青的秋苗	节节高；节节上升
犯了克山病，又得虎林热（虎疫，旧称霍乱）	没法治；没治了
犯人打（制）枷	自作自受
饭店里的臭虫	吃客
饭店里端菜	和盘托出
饭店里卖服装	有吃有穿
饭店门口摆粥摊	自讨晦气；多此一举
饭店门前摆粥摊	抢人生意
饭店墙上挂蒜辫	零揪
饭盒里盛稀饭	装糊涂
饭后的粑粑	可有可无
饭来张口，衣来伸手	坐享其成
饭勺敲铁锅	响当当；当当响
饭勺子上的苍蝇	混饭吃
饭堂里的苍蝇	人人讨厌
饭甑（zeng）里蒸黄连	苦闷（焖）
饭桌上的抹布	尝尽了酸甜苦辣
饭桌上的盘子	没把柄
范进中举	喜出望外；喜疯了
方不方，圆不圆	没有规矩
方铲挖耳朵	不入门
方枘（rui榫子）圆凿	格格不人
房顶的窟窿	漏洞
房顶开门	六亲不认
房顶上扒窟窿	不是门
房顶上长苗苗	野种
房顶上的冬瓜	两边滚
房顶上的窟窿	不是门儿
房顶上放风筝	起手高一层
房顶上栽花	难交（浇）
房顶上种麦子	刺激（脊）
房脊上晒豌豆	两边滚
房间里闹鬼	怪物（屋）
房角贴对联	邪（斜）门
房梁当椽子（chuan zi）	大材小用
房梁刻图章	大材小用
房梁上逮鸟	不好捉摸；难捉摸
房梁上挂鸡子儿（鸡蛋）	悬蛋
房梁上挂辣椒	一串一串的
房梁上挂水壶	高水平（瓶）
房梁做锄把	大材小用
房门前挖陷阱	自己坑害自己
房上的草	刮来的种儿
房上喜鹊叫喳喳	好事临头
房檐滴水	放任自流；任其自流；点点不差
房檐上逮鸡	不好捉弄（比喻猜测不出来。）
房檐上的流水	上头的事
房檐上吊的鱼	干起来了
房檐上玩把戏	玩命
房檐下的冰溜子	根子在上头；根在上边
房檐下吊磨盘	严（檐）重
房子烧了又挨大雨	内外交困
房子着了抢东西	趁火打劫
纺车耳朵	随人转
纺花锭插到荞麦囤	尖对棱
纺纱厂的烂线团	头绪太乱；千头万绪
纺织厂的下脚料	千丝万缕
放暗箭打冷枪	背后伤人
放白粉进棺材	害死人
放长线	钓大鱼
放出笼子的鸟	远走高飞；收不回来
放出去的风筝	越飞越远（比喻想得无边际。）
放大镜下的细菌	显而易见
放大镜照臭虫	原（圆）形毕露
放个屁也请示	没事找事；多此一举
放虎归山	必有后患；自找麻烦；留下祸根
放火烧山林	不顾根本
放了气的皮球	软蛋；硬不起来（比喻挺不起腰来。）
放了气的猪尿脬（pao膀胱）	硬不起来；软下来了
放了血的肥猪	软瘫了；软做一堆
放了血的猪	趴下了
放路纸钱	瘾（引）死人
放马后炮	没用了
放毛虫上身	找痒来抓
放牧的换草场	挪挪窝
放鸟儿出笼	各奔前程
放牛娃去放马	乱套了；乱了套
放炮仗（爆竹）崩瞎眼	自作自受
放屁踩着药捻子	赶到点子上了
放屁唱曲子	臭美
放屁打饱嗝	上下通气
放屁拉抽屉	遮丑
放屁扭着腰	真倒霉；倒霉透了
放屁捂屁股	多加一分小心
放屁摇头	臭羡
放屁咬紧牙	使暗劲；暗中使劲
放屁砸了脚后跟	真倒霉
放蚊入帐	自找麻烦
放下杈把拿扫帚	两手不闲
放下笛子拿钹	又吹又拍；吹吹拍拍
放下二胡拿笛子	能拉会吹；会吹会拉
放下屠刀，立地成佛	弃恶从善
放咸鱼入塘	不知死活
放鸭子的人	老落后
放羊的捡柴火	一举两得；捎带活
放羊的去圈马	乱套了；乱了套
放羊的拾柴禾	捎带
放羊娃打酸枣	捎带活
放羊娃盖楼房	发了洋（羊）财
放羊娃喊救命	狼来了
放羊娃拾粪	两不耽误；两得其便
放鱼归海	死活不知；不知死活
放在筐里的葱	难扎根
放着平路不走爬大坡	自讨苦吃
飞车走壁	尽兜圈子
飞蛾撵（nian追赶）蜘蛛	自投罗网
飞蛾撵蜘蛛	自投网罗
飞蛾扑灯	自取灭亡；惹火烧身；引火烧身
飞机打哆嗦	抖上天了
飞机打坦克	居高临下；一个天上，一个地下
飞机的屁股	尾巴翘上了天
飞机的尾日	翘得高；翘到天上去了
飞机翻跟头	倒栽葱
飞机放屁	一溜烟
飞机后面挂口袋	装疯（风）
飞机离跑道	没辙了；远走高飞
飞机上摆手	高招
飞机上唱大戏	高调
飞机上吃烧鸡	这把骨头不知往哪儿扔
飞机上吹喇叭	高明（鸣）；高调；想（响）得高
飞机上打凉扇	高风亮节
飞机上打拳	高手
飞机上打仗	放空炮
飞机上的婚礼	空喜
飞机上的客人	高贵
飞机上吊螃蟹	悬空八只脚；没着落
飞机上钓鱼	差得远；差远了
飞机上放鞭炮	想（响）得怪高（比喻想的很美好，或计划很宏大。）
飞机上放炮仗（爆竹）	天花乱坠
飞机上挂电灯	高明
飞机上挂剪刀	高才（裁）
飞机上观天	目空一切
飞机上过秤	高标准
飞机上军号响	声震远方
飞机上开会	高谈阔论
飞机上拉肚子	空对空；一泻千里
飞机上聊天	高谈阔论
飞机上扭秧歌	载歌载舞
飞机上沏茶	高水平（瓶）
飞机上扔钱	空头（投）支（纸）票
飞机上扔石头	一落千丈
飞机上撒网	空张罗；无限（线）上纲
飞机上晒衣服	高高挂起
飞机上生孩子	高产
飞机上抬头望	天外有天
飞机上跳伞	一落千丈；腾云驾雾
飞机上跳舞	空喜
飞机上张网	捕风捉影
飞机上装大粪	臭气熏天
飞机上作报告	空话连篇
飞机拖大炮	飞不起，跑不快
飞机钻云彩	腾云驾雾
飞了鸭子打了蛋	两落空；两头空
飞毛腿讲话	快人快语
飞鸟看出雌雄来	眼力好；好眼力
飞行员的降落伞	随机应变
飞行员跳伞	一落千丈
肥狗咬主人	忘恩负义
肥鸡饨汤	油水多
肥肉里挑骨头	没剔的
肥皂刻手戳（shou chuo图章）	不是这块料
肥皂沫当镜子	成了泡影
肥皂泡	不攻自破
肥皂泡当镜子	成了泡影
肥皂洗手	一干二净
肥猪跑进屠户家	送上门的肉
肥猪上屠场	挨刀的货
肥猪身上抹油	多此一举
废品堆里的铁锅	破烂货
废品加暇	物尽其用
废品收购站的仓库	全是破烂货
沸水锅里煮螃蟹	看你横行到几时（比喻行动蛮横，依仗暴力胡作非为的日子不会太久了。）
沸水煮孩子	熟人
坟场里演戏	给鬼看
坟场上堆冰块	冷死人
坟场上撒砒霜	害死人
坟场上舞大刀	吓死人
坟地里摆酒席	鬼作乐
坟地里的夜猫子	不是个好鸟儿
坟地里赶集	闹鬼
坟地里拉弓	色（射）鬼
坟地里卖布	鬼扯
坟地里冒青烟	阴阳怪气
坟地里躺个酒鬼	醉生梦死
坟墓变庙宇	神出鬼没
坟墓里戴口罩	阴一套阳一套
坟墓里埋砒霜（pi shuang砷的氧化物。剧毒）	阴毒
坟墓里招手	把人往死路上引
坟前的石碑	记生记死
坟头儿不叫坟头儿	土包子
坟头上的狗屎	又臭又硬；臭硬
坟头上的乌鸦	人人憎
坟头上拉屎	糟蹋死人
坟头上耍大刀	吓鬼（比喻吓唬不了人。）；吓死人
坟头上捅杆子	搅死人
坟头种牡丹	死风流
粉白墙上泼恶水（泔水）	尽是污点
粉白墙上贴告示	清清楚楚；一清二楚
粉球滚芝麻	多少污点
粉刷的乌鸦	白不久
粉丝汤里下面条	纠缠不清
粉条泡在滚水里	直不起腰来
粪叉上镶宝石	不值得
粪叉子抓痒	一把硬手；充硬手；是把硬手
粪车掉轮子	臭架子（比喻自高自大、装腔作势的作风。）
粪池子里泡豆芽	龌龊（wo chuo不干净）货
粪船过江	装死（屎）
粪船上放书柜	臭架子；摆臭架子
粪凼（dang水坑）里驾船	没有出路
粪堆上插旗子	臭名昭著
粪堆上插鲜花	臭美
粪堆上长灵芝	臭得出奇
粪堆上的灵芝	底子臭；根子不净
粪堆上开花	一阵香，一阵臭
粪缸盖上下棋	臭趣相投
粪缸里泡过的石头	又臭又硬
粪坑里出来的苍蝇	明摆着的。
粪坑里倒马桶	臭味相投
粪坑里捂出来的豆芽	腌腊（a zo脏；不干净）菜
粪坑上拜年	臭奉承
粪坑上吹喇叭	臭名远扬
粪筐上插花	死（屎）心眼
粪筐上的眼眼	死（屎）窟窿
粪里的蛆	没骨头
粪桶改水桶	臭气还在（比喻坏人或落后的人，旧思想、旧习气不断冒头。）
粪桶里洗萝卜	反惹一身臭
粪桶上镶宝石	不值得
丰都城（迷信传说指阴间）里唱大戏	鬼听
丰都城里说大书	鬼话连篇
丰收年景的粮囤子	冒尖
风车板做蒸笼	受了冷气受热气
风车尘土	不费劲；不费力
风车耳朵摇车心	转得快
风吹苞谷（玉米）穗	天花乱坠
风吹灯草	心不定
风吹灯笼	摇摆不定；左右摇摆
风吹鸡毛	忽上忽下
风吹芦苇	左右摇摆；摇摆不定
风吹落叶	一扫光
风吹麦苗	一边倒
风吹蒲公英	轻飘飘
风吹墙头草	两边倒
风吹头发	齐发动
风吹杨柳	左右摇摆；摇摆不定
风吹云朵	飘浮不定
风吹钟声花里过	又响又香
风吹竹林	一边倒
风地里的一盏灯	不知啥时候灭（比喻老人风烛残年，不知啥时死去。）
风干的抄手（馄饨）皮	捏不拢；难捏合
风化石磨刀	快不了
风口上的灯	难点
风口上点油灯	吹了
风浪里的小舟	摇摆不定；左右摇摆
风浪中行船	摇摆不定
风里点灯	不久长；难长久
风炉子不进气	缺个心眼
风马牛	互不相干；各不相干
风门上的皮条	来回拽（zhuai拉）
风前残烛	难长久；不久长
风前蜡烛	说灭就灭
风前烛，瓦上霜	危在旦夕
风扫落叶	全吹了
风湿膏止痛	治标不治本
风水先生唱大曲	阴阳怪调
风匣板做锅盖	受了冷气受热气
风箱板改锅盖	受了冷气受热气
风箱板做帽子	气上头了
风箱的嘴巴	光会吹
风箱换上鼓风机	一个比一个会吹
风箱里的老鼠	两头受气
风箱上做棺材	气死人
风雪山神庙	老天有眼
风雨中的泰山	不动摇
风筝脱了线	扶摇直上；摇摇欲坠
风中的羊毛	忽上忽下；不知下落；下落不明
风中鹅毛	无影无踪
封面上的美人	不可取（娶）
疯狗吃太阳	不晓得天高地厚（比喻不知事情的艰巨、严重。）
疯狗的脾气	见人就咬；乱咬人
疯狗的尾巴	翘不起来
疯狗咬刺猥	无处下口
疯狗咬人	叼着不放
疯狗咬日	白费工夫；白费劲；枉费工
疯狗咬月亮	狂妄（汪）；不知天高地厚
疯姑娘讲笑话	嘻嘻哈哈
疯牛钻进死胡同	不好回头
疯婆娘出门	没人敢惹
疯婆子演判官	人不人鬼不鬼
疯子写文章	怪话连篇
疯子摇头	呆头呆脑
疯子院的病人	喜怒无常
蜂儿没嘴	屁股伤人
蜂蜜拌黄连	又苦又甜
蜂蜜待客	给他（你）点甜头
逢年过生日	双喜临门
缝纫店里做衣服	量体裁衣
缝衣针当锥子使	通不过
缝衣针碰着绣花针	一个比一个尖；尖对尖
凤凰落到鸡窝里	有辱贵体
凤凰麻雀换巢	贵贱颠倒
凤凰山上没凤凰	徒有虚名
凤凰身上插鸡毛	多此一举
凤凰树开花	红极一时
凤凰头上戴牡丹	好上加好；美上加美
凤凰站在凉亭上	卖弄风流
佛多香少	供不应求
佛面刮金子	无中生有
佛爷的眼珠子	动不得
佛爷的桌子	碰不得
佛爷脸上刮金子	浅薄（剥）；细索求
夫妻开店	齐心合力
夫妻俩唱小调	一唱一和
夫妻俩吵嘴	常有的事；没事儿
夫妻两种甘蔗	甜蜜的事业
夫妻推磨	尽绕圈子；绕圈子
夫人病愈	太太好了
呋舵的小舟	随波逐流
伏天的烂鱼	臭货；肮脏货
伏天下暴雨	阵势大；来得凶，去得快
扶不上树的鸭子	贱骨头
扶得东来西又倒	顾此失彼
扶起篱笆倒了墙	顾东不顾西；顾此失彼
扶着栏杆上楼梯	稳步上升
扶着桥栏杆过河	生怕掉进水里（比喻胆小怕事。）
扶着醉汉过破桥	上晃下摇
服务员端茶	和盘托出
服务员拿钥匙	有职无权；当家不做主
服装店里的买卖	一套一套的
服装店里开饭店	有吃有穿
苻坚望见八公山	草木皆兵
浮萍遇洪水	随波逐流
浮在面上的水草	无依无靠
府官进县衙	大摇大摆
府官进衙门	直来直去；直出直人；大摇大摆；直进直出
斧大好砍树，针小能穿布	各有各用处
斧头打凿凿人木	一物降一物
父子观虎斗	大惊小怪
复印的材料	一模一样
富贵人家的小姐	弱不禁风
缚在线上的蚂蚱	跑不了
腹中容不得一根毛	肚量小
赶车不带鞭子	光拍马屁
赶鸡下河	往死里逼
赶集走亲戚	顺路的事
赶脚的骑驴	只图眼前快活
赶鸭子上树	办不到
赶着绵羊过火焰山	往死里逼
赶着绵羊上树	难往上巴（扒）结
擀面杖吹火	一窍不通
擀面杖敲鼓	抡的哪一槌
擀面杖钻石头	纹丝不动
刚捕上来的鱼虾	蹦蹦跳
刚出笼的馒头烤着吃	欠火
刚出笼的馍馍	带着气气
刚出山的太阳	红光满面
刚从水沟里钻出的泥鳅	黑不溜秋（比喻言行举止不大方。）
刚飞的鸟儿	不知高低
刚过门的小媳妇	扭扭捏捏
刚开坛的老酒	冲劲很大
刚来报到就要跳槽	这山望着那山高
刚买来的马	不合群
刚生的娃娃	毛腥气
刚下桥的新媳妇	不好看也爱看
刚学理发就碰上大胡子	难题（剃）（比喻不容易做的事情。）
刚摘下来的果	新鲜得很
缸里点灯	里头亮（比喻外表不怎么样，但里头好。）
钢厂的产品	全是硬货
钢铃打锣	另有音
钢钎打石头	硬钻
钢钎凿到石头	一捶一个眼
钢水倒进模子里	定了型啦
钢头戴铁帽	双保险
高大的乔木	腰杆硬
高大的竹子	节外生枝
高个子进窑洞	不得不低头
高价买来低价卖	尽做赔本事（比喻总有亏损。）
高梁秆上点火	一顺杆儿往上爬
高梁秆抬轿子	担当不起
高粱地里打伞	难撑
高粱地里放鸟枪	打发兔子起了身
高粱地里栽葱	矮一截子
高粱地里找棒子	瞎摆（掰）
高粱杆上挂个破气球	垂头丧气
高粱秆当柱子	撑（称）不起
高粱秆结茄子	不可恩议
高粱秆子挑水	担当不起
高粱米塌饭锅	闷（焖）起来了
高粱撒在麦地里	杂种；秋后见高低
高山上打鼓	远闻
高山上的青松	久经风雨
高山上的雪莲	不可多得
高山上滚马桶	臭气远扬（比喻臭名远扬。）
高射炮打老鹰	得不偿失
高射炮打蚊子	小题大作（大材小用）（比喻把小事当作大事来处理。）
高台上表演	众人仰望
高音喇叭掉井里	哇啦不上来了
高字边上加一手	你想搞哈
稿子写到边	不够格
胳膊折了往袖里藏	自掩苦处
胳膊肘子	往里弯
胳肢窝插鸡毛	假充外国鸟
胳肢窝下过日子	太窄
割了脖子鸡还想飞	垂死挣扎
割了脑袋还走十里路	人死心没死
割麦不用镰刀	连根拔
割碎鱼胆	暗暗叫苦
蛤蟆被牛踩	浑身是伤
蛤蟆蹦到脚面上	高升了；吓人一跳
蛤蟆剥皮	心不死
蛤蟆长毛	不可能的事
蛤蟆吃花朵	心里美
蛤蟆吃黄蜂	倒挨一锥
蛤蟆吃骰子（tou zi游戏用具或赌具）	一肚子点子；满肚子点子
蛤蟆吃萤火虫	心里亮；肚里明
蛤蟆打饱嗝	气胀的
蛤蟆戴帽子	充矮胖子
蛤蟆的眼睛	突出
蛤蟆的嘴	唱不出好歌
蛤蟆垫板凳	死撑活挨
蛤蟆垫桌腿	硬撑；鼓着肚子干
蛤蟆掉进滚水锅	死路一条
蛤蟆腚（ding臀部）上插鸡毛	不是正经鸟
蛤蟆跟着团鱼儿转	甘当龟孙子
蛤蟆骨头熬汤	没多大油水
蛤蟆挂铃铛	闹得欢
蛤蟆过河	一鼓作气
蛤蟆蝌蚪害头痛	浑身是病
蛤蟆蝌子害头痛	浑身是病
蛤蟆拉车	没后劲
蛤蟆爬楼梯	又蹦又跳；连蹦带跳
蛤蟆爬上樱桃树	想吃高味
蛤蟆晒肚	仰面朝天
蛤蟆跳到牛背上	自以为大
蛤蟆跳到热鏊（ao烙饼的炊具。铁制圆形平底）上	高兴一时是一时；快活不了多久
蛤蟆跳到热锅上	欢乐一时是一时（死）
蛤蟆跳井	不懂（不通）
蛤蟆跳门槛	又蹲屁股又伤脸
蛤蟆吞西瓜	无从下口；难下口
蛤蟆吞鱼钩	自找难受；自己寻死
蛤蟆无路	只得跳一步（比喻在处境困难的情况下，被迫采取的行动或办法。）
蛤蟆咬秤砣	没那个口劲
蛤蟆遇田鸡	难兄难弟
蛤蟆钻窟窿	眼光短，办法笨
蛤蟆嘴下落苍蝇	自送一口肉；送来的口食
隔壁包的饺子	谁知是什么馅儿
隔河走路	清清楚楚
隔口袋买猫儿	不知是黑是白
隔年的苍蝇	老不死
隔年的馒头	早发的
隔年的蚊子	老吃客
隔年历本	不用翻了
隔墙丢西瓜	给别人解渴
隔墙看花	伸不得手
隔墙撂帽子	不对头
隔墙扔扁担	横竖由他（它）去
隔山打斑鸠	枪也白费
隔宿猪头	冷脸
隔夜的菠菜	不水灵
隔着黄河握手	差得远
给狗起了个狮子名	有名无实
给了九寸想十寸	得寸进尺
给三岁孩子想媳妇	差半辈子
给死人送医	枉费功夫
给下山虎开路	头号帮凶
耕地里甩鞭子	吹（催）牛
耕牛吃羊草	怎能吃得饱
狗扯羊肠	越扯越长
狗吃豆腐脑	闲（衔）不住
狗吃青草	长着一副驴心肠
狗吃热肉	又爱又怕
狗吃王八	找不到头
狗吃猪肠	撒扯不清
狗逮老鼠猫看家	反常
狗戴礼帽	假装文明人
狗叼来的肉猫吃了	坐享其成
狗啃骨头	津津有味
狗脸不长毛	翻脸不认人
狗撵耗子	多替闲事
狗爬到猪槽里	吃混食
狗皮帽子	没反正
狗挑门帘	露一鼻子
狗吐舌头	热得很
狗尾巴草长在墙逢里	根子不正
狗尾巴上系鞭炮	追着炸
狗熊掰包谷	掰一个丢一个
狗熊拜年	不敢受这个礼
狗熊变黑瞎子	骗（变）自己
狗熊穿衣服	装人样
狗熊戴手表	假装体面
狗熊弹琴	没音
狗熊爬树	上劲
狗熊耍把戏	装人样
狗熊捉麻雀	瞎扑打
狗眼看人	咬穷不咬富
狗咬吕洞宾	不识好人心
股底下坐火箭	蹿儿啦
鼓槌打石榴	敲到点子上了
鼓肚蛤蟆钻喇叭	忍气吞声
鼓着肚子充胖子	外强中干
顾了翻锅，忘了烧火	一处不到一处乱
官老爷出告示	百姓该死；百姓遭难
棺材里的臭虫	咬死人
棺材里放屁	臭死人
棺材里伸手	死要钱
棺材铺的买卖	死活都要钱
棺材铺的生意	赚死人的钱
棺材铺掌柜的	想卖不敢说
光膀子打架	赤膊上阵
光膀子烤火	冷热结合
光膀子玩刀山	早晚有他的好看
光吃后悔药	没用
光打雷不下雨	虚张声势
光腚（出叩臀部）穿皮袄	顾上不顾下
光腚系围裙	顾前不顾后
光腚子戴口罩	顾嘴不顾身
光光头上的虱子	明摆着
光棍梦见娶老婆	尽想好事；想得倒美
光棍娶寡妇	两全其美；各得其所；自作主张
光讲骆驼，不讲蚂蚁	拣大的说
光脚丫进冰窖	凉到底了
光脚丫走进蒺藜（ji li一年生草本植物。果皮有尖刺）窝	进退两难
光筷子吃豌豆	滑头对滑头
光脑壳上落苍蝇	明摆着
光屁股穿大褂	顾上不顾下；凉了半截
光屁股打灯笼	献丑；自己献丑
光屁股赶贼	胆大不害臊
光屁股撵（nian驱逐；赶走）狼	胆大不害臊；又不要脸，又不要命
光屁股上战场	胆大不害臊
光屁股抬棺材	羞死人
光屁股推磨	转圈丢人
光屁股坐板凳	有板有眼
光身汉娶媳妇	心满意足
光身子骑老虎	胆大不害臊
光身子钻刀山	难活命；性命难保
光手逮刺猬	下不了手；无法下手
光说不练	嘴巴子戏
光头出家	两全其美
光头跑进和尚庙	充数
光头上面长虱子	无处藏身
光头上拍巴掌	正大（打）光明
光着脚板踩玻璃碴儿（小碎块）	走险
光着脚丫子走刀刃	自取其祸；惹祸上身，没事找事
光着脑壳打伞	无法（发）无天
广东人说北京话	南腔北调
龟背上刮毡毛	痴心妄想；妄想
闺女出嫁不想娘	白疼一场
闺女穿娘鞋	老样子；钱（前）紧
闺女回娘家	熟路；道熟
闺女遇见妈	说不完的话；话语多
鬼打觋公（xlqong男巫师）	无法
鬼门关止步	出生入死
鬼遇张天师	无法可使；有法难使
鬼子兵败阵	一窝蜂；死的死，丢的丢
鬼子兵进村	来者不善
鬼子兵弄刀枪	杀气腾腾
鬼子兵逃命	屁滚尿流
刽子手吃斋	冒充善人
刽子手咧嘴	笑里藏刀
刽子手念经	假充善人
刽子手烧香	假慈悲；假慈善
贵妃娘娘叹气	不顺心
贵州驴子学马叫	南腔北调
桂花树旁搭茅房（厕所）	一阵香；一阵臭
桂花种在厕所旁	香风臭气
桂林三花酒	好冲
跪在老虎面前喊恩人	善恶不分
跪着养猪	看在钱份上
滚石下山	一砸到底
滚水锅里捞出的棉花	熟套子
滚水锅里劳活鱼	荒唐
滚水锅煮娃娃	熟人
滚水泡米花	开心
滚水泼老鼠	在劫难逃
滚水泼蚂蚁	一窝都是死
滚水煮饺子	你不靠我，我不靠你
滚汤锅里的螺蛳	水深火热
滚油锅里捡金子	难下手；下不了手；无法下手
滚油锅里添凉水	炸了
滚油锅里炸油条	翻来覆去
棍子蘸（zhan）石灰	白打
锅巴雕灯影儿（皮影戏中的人物剪影。用兽皮或纸皮板做成）	焦人
锅边上的小米	熬出来的
锅边上的油渣	练（炼）出来的
锅底上戳窟窿	捅漏子
锅底笑话缸底黑	光看别人黑，不见自己黑
锅盖上的米花子	熬出来的；受尽了煎熬
锅盖上的米粒	熬出来的
锅盖做风箱	受了热气受冷气
锅里的鸡	难飞
锅里的螃蟹	横行不了几时
锅里的鱼	别想跳了
锅里剖西瓜	滴水不漏；点滴不漏
锅里扔石头	砸啦
锅里煮扳不倒（不倒翁）	熟人
锅炉房里的灯笼	气昏了
锅台上的油渣	练（炼）出来的
锅台上种地	没几分
锅台上种瓜	难发芽
锅堂里的老鼠	灰溜溜
锅灶上天	气炸了；气崩了
国画馆里倒垃圾	尽废话（画）
裹脚布放风筝	臭名远扬
裹脚布挂在旗杆上	打的什么旗号
裹脚布做阳伞	一步（布）登天
裹脚布做衣领	臭一圈
过道里赶猪	直来直去；直进直去
过道里掮（qian扛）椽子	直来直去；直进直出；直出直人
过冬的大葱	皮焦根枯心不死；叶烂皮干心不死
过冬的田螺遇春水	扬眉吐气
过端午的龙头	光耍嘴，
过坟场吹口哨	给自己壮胆
过河拆桥	忘恩负义
过河抽板子	不留后路
过河打船工	恩将仇报；以怨报德；好心不得好报
过河的牛尾巴	拽（zhuai拉）不动
过河的卒子	横竖都行；只进不退；没退路
过河摸屁股	小心过度（渡）
过河碰上摆渡的	巧极了；难得；得之不易；凑巧了；正好
过河洗脚	一举两得
过河拽胡子	谦虚（牵须）
过河卒子做生意	一卖到底
过街的老鼠	人人喊打
过了年的桃符	没用处；没得用
过了霜降收玉茭（玉米）	晚了三秋；迟了；晚了
过了银桥过金桥	越走越亮堂；越走越明
过路人打狗	边打边走
过路人吊丧	死人肚里明白
过年吃团圆饭	济济一堂
过年的肥猪	早晚得杀
过年借礼帽	不识时务
过年敲锅盖	穷得丁当响
过年娶媳妇	双喜临门
过期的车票	失效了
过时的历书	没用处；翻不得
过时的药	失效了；没用
哈巴狗带串铃	充什么大牲口（比喻小人物装作大人物的样子。）
哈巴狗戴串铃	假充大牲口
哈巴狗掉进茅坑里	饱餐一顿
哈巴狗过高门槛	又蹲肚子又伤脸
哈巴狗见主人	摇尾乞怜；俯首贴耳
哈巴狗上轿	不识抬举
哈巴狗舔脚跟	亲的不是地方（比喻场合不对）
哈巴狗掀门帘	突出一张嘴
哈巴狗摇尾巴	献殷勤
哈巴狗咬月亮	不知天高地厚；不知高低
哈巴狗坐轿	抬举畜牲；不识抬举
哈尔滨钓冰雕	冷冰冰；硬梆梆
哈哈镜放在大街上	惹人见笑
哈哈镜照人	怪模怪样；变样了
哈蟆鼓肚子	气鼓气胀
孩儿脸	说变就变；变化无常
孩子的脊梁	小人之辈（背）
孩子的节日	儿戏
孩子讲悄悄话	由他说去
孩子考妈妈	小题大做
孩子离开娘	无依无靠
孩子没娘	说来话长
孩子们过年	常盼那一天（比喻希望有那么一天）
海边的大雁	见过风浪
海滨的潮汐	一浪高一浪；后浪推前浪
海底长海带	根子深
海底打捞绣花针	难办
海底打拳	有劲使不上；有力无处使
海底的坑洼	摸不透
海底动物	不见天日
海底捞月，天上摘星	想得到，办不到（比喻幻想容易，要真正做到那是不可能的。）
海底捞针	往哪儿找去（比喻极难寻找，或不容易办到）
海底谋杀	害人不浅
海底栽葱	根底深
海风阵阵	一波未平，一波又起
海椒（辣椒）命，姜桂性	越老越辣
海军的衬衫	道道多
海龙王吃螃蟹	敲骨吸髓
海龙王打哈欠	好大的口气
海龙王的喽哕	虾兵蟹将
海绵里的水	挤出来的；不挤不出
海面上刮风	波澜起伏
海面上起风	不平静
海瑞上书	为民请命
海上的孤舟	无依无靠
海上泛舟	漫无边际
海上观测	往远处看
海上聊天	漫无边际
海石秃上的螃蟹	明摆着
海市蜃楼，天涯彩虹	虚的虚，空的空
海水里长大的官	管得宽
海水煮黄连	苦上加苦
海滩上的沙子	有的是；多的是
海象打架	光使嘴
海蜇头做帽子	装滑头
害喘病爬高山	喘不上气；上气不接下手
害儿子坑闺女	灭绝人性
害脚气长秃疮	两头落一头
害了伤寒病	忽冷忽热
害亲人挖祖坟	无恶不作
含冰糖说好话	甜言蜜语
寒冬的电扇	令人生畏
寒冬腊月摆龙门阵	冷言冷浯
寒冬腊月吃冰水	点点人心
寒冬腊月打雷	成不了气候
寒冬腊月的马蜂窝	空空洞洞；空洞
寒冬腊月喝冰水	肚里有火；心都凉了
寒号鸟晒太阳	得过且过
寒流来了吹暖气	冷嘲（潮）热讽（风）
寒山寺里的大钟	搬不动
寒暑表里的水银柱	能上能下
寒天吃冰棍	心里有火
韩湘子出家	一去永不回；一去不复返
韩湘子吹箫	不同凡响
韩湘子的花篮	要啥有啥
韩湘子拉着铁拐李	一个吹，一个捧；你吹我捧
韩信点兵	多多益善
韩信将兵	多多益善
汉高祖斩白蛇	一刀两断
旱地的北瓜	越老越红
旱地的葱过道的风，蝎子的尾巴财主的心	又毒又辣又刺人
旱地的倭瓜（南瓜）	越老越红
旱地的乌龟	无地容身；无处藏身；无处逃生
旱地的鱼虾	难活命；性命难保
旱地里的蛤蟆	干鼓肚，没办法
旱地里的泥鳅	钻得深
旱地里的螃蟹	横行不了几天
旱地鱼虾	活不下去了（比喻生活苦，不好活下去）
旱苗得雨	正逢时
旱枪的喷嘴	一点就着；点火就着
旱天的井	水平低
旱天的庄稼苗	死不死；活不活；要死不活
旱天逢甘霖	正适时；正合适
旱鸭子不下水	练腿劲
旱鸭子过河	不知深浅；摸不着深浅
旱鸭子追猫	紧赶
旱烟袋打鸟	不像腔（枪）；不是真腔（枪）
旱烟袋当枪使	派错了用场
焊条碰钢板	冒火
航船上的耗子	混充带毛的货
航船遇沙滩	搁浅
航空兵操纵	随机应变
航天飞机出发	远走高飞
毫鹰抓住鹞（yao）子脚	难解难分
豪猪拱洞	吃里爬外
好袄做成破马褂	穷折腾
好吃不好穿	顾嘴不顾身
好斗的山羊	顶顶撞撞；又顶又撞
好儿无好媳	美中不足
好汉不吃眼前亏	识时务
好汉上梁山	逼出来的
好花插在牛粪上	可惜；真可惜
好花插在牛屎上	真可惜
好花离了枝	蔫（植物因失去水分而枯萎）了
好经念给聋施主	白费口舌
好马不吃回头草	倔强
好马遭鞭打	忍辱负重
好女嫁丑汉	不般配
好女嫁歹汉，驴子吃牡丹	搭配不当
好人喊冤	不平则鸣
好人坐班房	不白之冤
好肉上贴橡皮膏	自找麻烦
好心当成驴肝肺	不识好歹
好心遭雷打	冤枉；太冤枉
号手出身	会吹
号筒里塞棉花	吹不响
号筒塞棉花	吹不响；吹不得
号嘴上贴封条	别吹
耗干了油的灯火	奄奄一息（熄）
耗子搬家	穷折腾
耗子搬生姜	劳而无功；白费力
耗子不留隔夜粮	吃光用光
耗子吃砒霜（pi shuang砷的氧化物。剧毒）	翻白眼；性命难保
耗子充蝙蝠	白熬夜
耗子出洞	东张西望；先听动静
耗子打洞	找门路
耗子打瞌睡	不显眼
耗子戴眼镜	鼠目寸光
耗子倒洞	走后门
耗子的眼睛	只看一寸远（比喻目光短浅。）
耗子的眼镜	目光短浅；只看一寸远
耗子掉到醋缸里	一身酸味
耗子掉进面缸里	白眼看人
耗子掉水缸	时髦（湿毛）
耗子跌进坛子里	无缝可钻
耗子跌米缸	好进难出；又喜又悲
耗子盯小偷	贼眉鼠眼
耗子洞摆神像	莫明其妙（庙）
耗子洞里打架	窝里战；自相残杀
耗子逗猫	惹祸上身；没事找事
耗子给猫捋胡子	溜须不要命（比喻拼命巴结）
耗子攻墙	家贼难防
耗子拱墙根	没缝打缝
耗子滚到面柜里	乐糊涂了
耗子滑冰	溜得快
耗子嫁猫	送死；找死；自己找死
耗子嫁女	讲吃不讲穿
耗子见猫	赶快逃；逃不了就没命
耗子进老鼠夹	离死不远
耗子进书箱	蚀（食）本
耗子扛枪	窝里横
耗子啃菜刀	死路一条
耗子啃碟子	满嘴词（瓷）
耗子啃海椒（辣椒）	够戗（够受的）
耗子啃罗汉	不识大体
耗子啃木头	吃不消
耗子啃木箱	闲磨牙
耗子啃皮球	客（嗑）气
耗子啃书本	咬文嚼字
耗子窟窿	填不满
耗子拉鸡子儿（鸡蛋）	滚蛋
耗子拉木锨	大头在后边
耗子磨牙	没话找话
耗子爬秤钩	自称自．
耗子爬到牛角上	自以为大
耗子爬到树梢上	自高自大
耗子爬铁丝	难转弯；转不过弯来；转不得身
耗子爬竹竿	一节节来
耗子上吊	猫逼的
耗子伸腿	小手小脚
耗子生儿	喂猫的货
耗子睡猫窝	自送一口肉；送来的口食；不知死活
耗子睡在粮仓里	不愁吃
耗子舔猫鼻子	找死；自己找死
耗子舔猫屁股	送死
耗子跳到钢琴上	乱谈（弹）
耗子跳火坑	爪干毛净
耗子偷糨子（jiang zi糨糊）	煳（糊）嘴
耗子偷米汤	勉强糊得着嘴巴
耗子腿上摆宴席	小题（蹄）大做
耗子拖牛	大干一场
耗子尾巴上长癣	小毛病
耗子眼看天	小瞧
耗子在铁板上打洞	钻不透
耗子在窝里藏粮	有备无患
耗子找枪	窝里反
耗子钻到竹筒里	死不回来
耗子钻到字纸篓	咬文嚼字
耗子钻风箱	两头咬气；自找罪受
耗子钻灰堆	闭着眼混
耗子钻进古书堆	吃老本
耗子钻牛角	没有出路；死路一条
耗子钻象鼻	大的没有小的能；小能降大
耗子钻油房	吃香
耗子钻油壶	有进无出，
喝茶拿筷子	摆设
喝敌敌畏跳井	必死无疑
喝海水长大的	见过风浪
喝江水说海话	无边无沿
喝酒不吃菜	各人心里爱
喝酒不拿盅子	胡（壶）来
喝酒穿皮袄	里外发烧（比喻走运，突然好了起来）
喝酒尿裤子	松包
喝酒晒太阳	周身火热
喝冷酒，拿赃钱	迟早是病
喝凉水吃生姜	乏味；不是滋味
喝凉水肚子痛	自找罪受
喝凉水拿筷子	多此一举；没有用
喝凉水塞牙缝	倒霉透了；真倒霉
喝凉水剔牙缝	没事找事
喝凉水栽跟头	装晕
喝了黄连猪胆汤	一肚子苦水
喝了迷魂汤	昏头昏脑；神魂颠倒
喝了柠蒙水	心里酸溜溜的
喝了泉水就摔瓢	忘本
喝了烧酒烤火	浑身发热
喝了太平洋的水	宽大无边
喝了五味汤	啥滋味都有
喝了一坛子山西醋	酸心透了
喝米汤划拳	图热闹
喝磨刀水长大的	内秀（锈）;秀（锈）气在内
喝水拿筷子	用不着（比喻没有用。）
喝水塞牙缝，放屁扭了腰	该倒霉
喝松花江水长大的	管得宽
喝完浆水上吊	糊涂死了
喝西北风长的	没点热乎气
喝西北风打饱嗝	硬挺
喝西北风堵嗓子	倒霉透了
喝盐开水聊天	尽讲闲（盐）话
喝足酒跳太湖	罪（醉）该万死
禾草里头藏龙身	农家出英才
禾苗怕蝼蛄	一物降一物
合唱团里的哑巴	凑数
何家的姑娘嫁郑家	正合适（郑何氏）
何仙姑要下凡	六神无主
和尚拜堂	全是外行
和尚拜丈人	没有这回事
和尚背枷	知法犯法
和尚出山	走下坡路
和尚打赤脚	两头光
和尚打架扯辫子	没有的事（比喻某件事不可能发生，或对某件事表示否定。）
和尚打架	抓不到辫子
和尚打伞	无法（发）无天
和尚戴礼帽	与众禾同
和尚到了姑子庵	不妙（庙）
和尚的肚腹	没多大油水
和尚的儿子	拣的
和尚的袈裟	东拼西凑；七拼八凑
和尚的木鱼	合不拢嘴；挨敲打的货；不打不响；咧开了嘴
和尚的脑壳	没法（发）（比喻没有办法，无能为力）
和尚的念珠	一连串
和尚的梳子	无用之物
和尚的住处	妙（庙）
和尚分家	多事（寺）
和尚跟着月亮走	借光了
和尚回庙	走老路
和尚结辫子	假的
和尚看花轿	空欢喜
和尚买梳子	无用
和尚没当上，老婆没娶上	两头误
和尚庙对着尼姑庵	没事也得有事
和尚庙里的老鼠	听的经卷多
和尚庙里借梳子	走错了门；找错了门
和尚庙前讲假话	惹是（寺）生非
和尚念经	老一套
和尚敲木鱼	老一套
和尚敲钟	响当当
和尚娶老婆	岂有此理；离经叛道
和尚娶媳妇	今生休想
和尚头上的虱子	明摆着
和尚头上盘辫子	空绕一圈儿（比喻白走一趟）
和尚挖墙洞	妙（庙）透了
和尚下山	出事（寺）了
和尚训道士	管得宽
和尚训道土	管得宽
和尚养儿子	岂有此理
和尚照镜子	无计（髻）可施（梳）
和尚枕着门槛睡	突（秃）出
和尚住岩洞	没事（寺）
和尚坐岩洞	没事（寺）
和孙猴子比翻跟斗	差着十万八千里
河边垂钓	等鱼上钩
河边放崖炮	无地容身；无处藏身
河边开豆腐店	汤里来，水里去
河边里海洗煤砖	闲着无事干
河边上撑篙	一竿子插到底
河边上逮螃蟹	有一个捉一个
河伯娶妻	坑害民女
河里打墙	把鳖的路档了
河里的鹅卵石	光溜溜
河里的木偶	随大流・
河里的泥鳅种，山上的狐猩王	老奸巨滑
河里的沙子	捏不拢；难捏合
河里的水身旁的风	抓不住
河里的鸳鸯	一对儿
河里赶大车	没辙
河里划龙船	同心协力
河里拉屎	只有他（你）自己知道
河里摸鱼	光溜溜的
河里洗铁盒	面面俱到
河马打呵欠	好大的口气
河南到河北	两省
河水不犯井水	互不相干；各不相干
河滩的沙子	有的是；多的是
河滩的石头滚上坡	无奇不有；天下奇闻
河滩里盖房子	靠不住；不可靠
河滩上的沙子	有粗有细
河豚浮在水面上	气鼓气胀；气鼓鼓
河心的船	明摆着
河心搁跳板	两头脱空
河中的礁石	顶风顶浪
核桃里的肉	不敲不出来
核桃皮翻脸	点子不少
核桃树旁种棉花	软硬兼施
荷包里的东西	十拿九稳
荷包里冒烟	妖艳（腰烟）
荷包里装针	锋芒毕露
荷花池里的并蒂莲	不分上下；上下不分
荷花池里养鱼	一举两得
荷花灯里点蜡烛	心里明；肚里亮
荷塘里失火	偶然（藕燃）
荷叶包钉子	个个想出头
荷叶包鳝鱼	溜啦；溜之大吉
荷叶上的露珠	清清白白；滚来滚去
荷叶上的水珠	滚来滚去（比喻容易动摇，没有主见。）；不能久留
荷叶上放秤砣	承受不了
荷叶做雨伞	遮盖不住
黑处作揖	各尽其心；没人领情
黑灯笼里点蜡烛	有火发不出
黑灯瞎火跳舞	暗中作乐
黑地里穿针	难过
黑地里打躬	没人领情；不领情
黑地里张弓	暗藏杀机
黑洞里裹脚	瞎缠
黑狗偷油打白狗	错了；搞错了
黑狗熊耍扁担	胡抡
黑老鸹嫁凤凰	不配；配不上
黑老鸦下了个白鸡蛋	就当自己长得白
黑脸演花旦	变了角色
黑泥鳅钻进金鱼缸	谁跟你比美；光显自己漂亮；献丑
黑漆灯笼	心里亮；肚里明；没用处
黑天摸黄鳝	不知长短；难下手
黑天捉老鼠	找不着窟窿
黑天捉牛	摸不着角
黑天做投机生意	看不见的勾当
黑屋里打算盘	暗算；暗中盘算
黑屋里找东西	没处寻；难寻
黑屋里做活路	瞎干
黑瞎子（狗熊）挨鞭子	耍坏啦
黑瞎子按键盘	乱弹琴
黑瞎子掰苞谷（玉米）	掰一个，丢一个
黑瞎子摆手	不玩了
黑瞎子吃人参	不知贵贱
黑瞎子打花脸	熊样
黑瞎子打立正	一手遮天
黑瞎子打人	架不住那一巴掌
黑瞎子叫门	熊到家了
黑瞎子蒙红头巾	冒充新娘子
黑瞎子扭身	大反扑
黑瞎子捧刺猬	碰到棘手事
黑瞎子披大氅（chang大衣）	不像人样
黑瞎子敲门	熊到家了
黑瞎子上房脊	熊到顶了
黑瞎子耍扁担	老一套
黑瞎子耍门扇	人熊家伙笨
黑瞎子跳井	熊到底了
黑瞎子头上长犄角	还是那个熊样子
黑瞎子照镜子	熊样
黑瞎子装弥勒佛	面善人不善
黑瞎子坐花轿	冒充新娘子
黑瞎子坐月子	吓（下）熊了
黑小烂肚肠	坏透了
黑心的萝卜	坏透了
黑旋风的本名	理亏（李奎）
黑夜里摘黄瓜	不分老嫩
黑夜里追人	无影无踪
黑纸糊灯笼	不明不白
狠心后娘打孩子	暗里下手
恨虱子烧棉袄	得不偿失；不值得
哼哈二将	样子凶
横匾压塌龙王庙	好大的牌子
横打竹竿进宅	不入门
横垄地里撵（nian追赶）瘸子	一步跟不上，步步跟不上；一步赶不上，步步都紧张
横垄台拉石磙	步步有坎；一步一个坎
横着扁担走路	霸道
横着竹竿进门	难转弯；转不过弯来
红白喜事一起办	哭笑不得；悲喜交加
红楼梦里的贾府	大有大的难处
红萝卜菜放辣椒	把你没放在眼里
红萝卜雕花	中看不中吃；好看不好吃
红萝卜雕神像	饮食菩萨
红萝卜掉油篓	又奸（尖）又猾（滑）
红萝卜刻娃娃	红人
红木当柴烧	不识货
红娘挨打	成全好事
红娘牵线	成人之美
红薯干充天麻	冒牌货
红薯窖里打拳	施展不开
红薯落灶	自该煨
红头苍蝇叮烂猪头	臭味相投
红眼老鼠出油缸	吃里爬外
红药水抹疖子	治表不治里
红枣炖红糖	甜上加甜；甜透了
红纸裱灯笼	装面子
洪水淹粮仓	泡汤了
洪水淹了龙王庙	一家人不识一家人
鸿雁传书	空来往
侯门的小姐，王府的少爷	四体不勤，五谷不分
喉咙长刺口生疮	说木出好话来
喉咙卡骨头	吞不下，吐不出
喉咙里安雷管	一谈（弹）就崩
喉咙里长疙瘩	赌（堵）气
喉咙里灌铅	张口结舌
喉咙里塞胡椒	够戗（够受的）
喉咙里伸出手来	真馋；嘴太馋
喉咙里使勺子	淘（掏）气
喉头上长疔疮	痛不可言，
猴吃辣椒	抓耳挠腮
猴戴皮巴掌	毛手毛脚
猴弹棉花狗拉车	乱套了；乱了套
猴儿吃芥末（调味品。味辣）	傻了眼；翻白眼
猴儿戳蜂窝	自讨苦吃
猴儿戴帽子	装人样；衣冠禽兽
猴儿的脸，猫儿的眼	说变就变；转眼就变；变化无常
猴儿拿棒槌	胡抡
猴儿爬石崖	显出你的能耐了
猴儿耍大刀	胡砍
猴屁股扎蒺藜（ji li一年生草本植物。果皮有尖刺）	坐立不安
猴王闹王宫	大打出手
猴于爬梯	一跃而上
猴子掰（bai用手把东西分开或折断）苞米（玉米）	掰一个；丢一个
猴子抱西瓜	顾此失彼
猴子不上树	多打几遍锣
猴子唱大戏	胡闹台
猴子吃大蒜	翻白眼
猴子吃大象	亏他张得开嘴
猴子吃核桃	砸啦
猴子吃麻糖	扒拉不开
猴子吃仙桃	眉飞色舞；好歹不分
猴子穿衣服	冒充善人
猴子戴箍	自上圈套
猴子戴金冠	惹祸大王
猴子戴面具	混充人；人面兽心
猴子戴手套	毛手毛脚
猴子戴眼镜	冒充斯文；假斯文
猴子的屁股	自来红；坐不住
猴子登台	一出没有（指无戏可唱）
猴子给老虎拜年	送货上门
猴子滚绣球	滚的滚，爬的爬；连滚带爬
猴子架辕	不听那一套；不吃这一套
猴子捡姜	吃也不是，丢也不是
猴子看桃园	越看越光
猴子看戏	干瞪眼；傻了眼
猴子扛大梁	受不了
猴子拉车	又蹦又跳；连蹦带跳
猴子拉弓	不是样子
猴子拉犁	顶车
猴子拉稀	坏肚肠
猴子捞月亮	一场空
猴子拿（捉）虱子	瞎抓
猴子爬板凳	各想一头
猴子爬杆狗钻圈，黄鼠狼专钻水道眼	各有各的门道
猴子爬上旗杆顶	高高在上
猴子爬上樱桃树	粗人吃细粮
猴子爬树	乱蹿；拿手好戏
猴子爬皂角树	遇上棘手事
猴子爬竹竿	节节上升；上蹿下跳
猴子捧个烫瓦盆	团团转
猴子骑老虎	下不来
猴子骑马	一跃而上；高高在上
猴子骑绵羊	神气活现；神气十足
猴子骑羊	不成人马
猴子扇扇子	学人样
猴子上凉亭	丑鬼耍风流
猴子上圈套	任人摆布
猴子耍把戏	毛手毛脚；翻来覆去老一套
猴子耍扁担	胡抡
猴子耍耗子	大眼瞪小眼
猴子耍拳	小架式
猴子跳加官（旧时戏曲开场或在演出中，遇显贵到场时，加演的舞蹈节目）	人面善心
猴子捅马蜂窝	倒挨一锥
猴子推磨	玩不转
猴子衔烟斗	混充人；装人样；假装
猴子笑兔子尾巴短	彼此彼此；彼此一样
猴子照镜子	得意忘形；没个人模样；里外不是人
猴子捉跳蚤	自抓挠
猴子着西装	不合身
猴子坐板凳	有板有眼；有板眼
猴子坐到旗杆上	惟我独尊
猴子坐金殿	一个惹祸大王
猴嘴里掏枣，狗嘴里夺食	难办；办不到’
后半夜做美梦	好景不长
后婚娶后婚	床上两条心
后脑壳上的头发	难见面
后脑勺挂镜子	照见别人，照不见自己；照人不照己
后脑勺挂笊篱（dlbo li捞取东西的用具。用金属丝、竹篾或柳条等编成。有长柄）	置之脑后
后脑勺拍巴掌	背后整人
后娘打孩子	暗里使劲；使暗劲；早晚是一顿
后台锣鼓	见不了大场面
候车室里的挂钟	群众观点
囫囵吞石榴	先苦后甜
囫囵吞枣	难消化；不知滋味
囫囵吞芝麻	满肚子点子；一肚子点子
狐狸吵架	一派胡（狐）言
狐狸吃刺猬	下不了口；无从下口；难下口
狐狸出洞	没好事儿
狐狸打马蜂	不懂得死活
狐狸戴草帽	不算人；不是人
狐狸戴礼帽	假正经；人面兽心
狐狸的尾巴	藏不住
狐狸掉进污水池	又臊又臭
狐狸洞里扛扁担	窝里横
狐狸放屁	臊气
狐狸给鸡拜年	不怀好意；阴险歹毒
狐狸给鸡祝寿	不敢受这个礼
狐狸跟猎人走	凶多吉少
狐狸跟着老虎走	狐假虎威
狐狸和狗拜把子（朋友结为异姓兄弟）	狐群狗党
狐狸嫁黄鼠狼	都是骚（臊）货；一对骚（臊）货
狐狸进村	没安好心
狐狸进宅院	来者不善
狐狸精变美女	迷人心窍
狐狸精打呵欠	妖里妖气
狐狸看鸡	越看越稀
狐狸哭兔子	假慈悲；假慈善
狐狸说教	旨在偷机（鸡）
狐狸窝里斗	自相残杀
狐狸想天鹅	不得到口
狐狸找羊交朋友	不存好心；居心不良
狐狸照镜子	怪模怪样；怪样子
狐狸撞猎枪	死到临头
狐狸钻罐子	藏头露尾
狐狸作梦	想着投机（偷鸡）
狐狸做梦	想投机（偷鸡）
胡豆地里出油菜	杂种
胡椒浸在醋里	辛酸得很
胡萝卜疙瘩	上不了席
胡萝卜煮豆腐	红白不分
胡敲梆子乱击磐	欢喜若狂；得意忘形；快活一时算一时
胡琴里藏知了	弦外之音；弦外有音
胡琴上吊铜铃	弦外之音
胡琴与琵琶合奏	谈（弹）到一块去了
胡同里扛竹竿	直来直去；直进直出；难回头；回头难
胡同里演戏	口上热闹
胡子上的饭，牙缝里的肉	不大点
胡子上的饭粒	吃不饱肚子；饱不了人
胡子上挂霜	一吹就了
胡子套索索	谦虚（牵须）
胡子贴膏药	毛病
壶里没水	白捎（烧）了
壶里伸进烧火棍	胡（壶）搅
壶里煮粥	不好搅
湖底的鱼	不好打；打不起来
湖南到湖北	两省
猢狲戴帽子	学做人
猢狲骑山羊	抖威风
猢狲人布袋	进了圈套
猢狲耍把戏	老一套；有啥本事都拿出来
猢狲推泰山	自不量力；不自量
葫芦锯了把儿	没嘴儿
葫芦壳挂在房梁上	上不着天，下不着地
葫芦里看天	不知所以
葫芦里装糯米饭	好进难出
葫芦落塘	摇摇摆摆；吞吞吐吐
葫芦蔓缠上南瓜藤	难解难分
葫芦瓢捞饺子	滴水不漏；点滴不漏
葫芦瓢	里虚
葫芦上架	吊起来了
葫芦藤上结南瓜	不可能的事；无奇不有；天下奇闻
葫芦秧套南瓜秧	拉扯不清；胡搅蛮缠
糊涂虫做媒	坏两头；两头挨骂
糊涂官判案	是非不清
糊涂老板糊涂账	难算；算不清
糊涂老婆	乱当家
糊涂庙里糊涂神	糊涂到一块了
蝴蝶飞进了花园里	难舍难离
蝴蝶落在鲜花上	恋恋不舍
蝴蝶群舞	花花世界
虎口拔牙	胆子不小；好大胆
虎人中堂	家破人亡
虎生猪猡	又笨又恶
虎头蛇尾	有始无终
虎头铡下服刑	一刀两断
虎窝里跑出个羊羔	虎口余生
虎坐莲台	冒充善人
花棒棒打锣	有声有色
花绸上绣牡丹	锦上添花
花绸子盖鸟笼	外面好看里面空
花绸子做尿布	屈才
花旦戴胡子	没有那一套
花岗岩脑袋	顽固不化
花岗岩做招牌	牌子硬
花公鸡的尾巴	翘得高
花公鸡上舞台	光显自己漂亮
花果山的猴子	无法无天
花果山的美猴王	个小本领强
花和尚穿针鼻	大眼瞪小眼
花花枕头装秕糠（bi kang秕子和糠）	外面好看里面空
花架下养鸡鸭	煞风景
花椒木雕孙猴	麻木不仁（人）
花椒树	尽刺儿
花椒煮猪头	肉麻
花轿到了家门口	喜气盈盈
花轿没到就放炮	高兴得太早了
花轿前的乐队	大吹大擂
花篮里装泥鳅	跑的跑，溜的溜
花狸猫卧房顶	活受（兽）
花猫蹲在屋脊上	惟我独尊
花木兰从军	冒名顶替
花盆里栽松树	成不了材
花皮蛇遇见饿蛤蟆	分外眼红
花瓶里栽树	大不了
花铺里的水	滚开
花钱买死马	得不偿失；尽干蠢事
花生地里开花	落地生根
花生壳，大蒜皮	一层管一层
花生壳里的臭虫	冒充好人（仁）
花生米掉锅里	熟人（仁）
花心萝卜充人参	冒牌货
花眼婆婆纫针（ren zhen引线穿过针鼻儿）	对不上眼；不对跟
花眼婆婆绣花	模糊不清；看不清
花园里的牡丹	出类拔萃
花子（乞丐）进庙	穷祷告
花子婆娘翻跟头	穷折腾
花子婆娘画眉毛	穷讲究；究打扮
花子养仙鹤	苦中作乐
花子早起	穷忙
华佗的医术	手到病除
华佗施医术	起死回生
华佗行医	名不虚传
华佗治病	手到病除
滑了牙的螺丝帽	团团转
化了装的演员	油头粉面
化脓的疖子	不攻自破
画笔敲鼓	有声有色
画饼充饥	白欢喜；自欺欺人；自己哄自己
画虎不成反类犬	弄巧成拙
画里的大饼	不能充饥
画上的春牛	中看不中用
画上的大虾	看着眼馋，到不了嘴里
画上的马	不奇（骑）
画上的美人儿	爱不得
画上的鸟	有翅难飞
画上的仙桃	好看不好吃；中看不中吃
画上的元宝	不值钱的货
画蛇添足	多此一举
话里揉进胡椒面	辣得很
桦木拐杖	宁折不弯
怀揣苞米（玉米）	不肯（啃）
怀揣刺猬	抱着嫌扎手，丢又舍不得
怀揣火炉	热心肠
怀揣金子	心里沉重
怀揣兔子	忐忑（tan te）不安；不安
怀揣小拢子（梳子）	舒（梳）心
怀里揣刀子	不存好心；居心不良
怀里揣镜子	心里明
怀里揣马勺	诚（盛）心
怀里揣琵琶	往心里谈（弹）
怀里揣笊篱（zhao li捞取东西的用具。用金属丝、竹篾或柳条等编成。有长柄）	劳（捞）心了；心眼多
怀里揣着十五只兔子	七上八下
槐树上要枣吃	强人所难
坏笤帚对烂畚箕（ben ji簸箕。用竹、木、铁片等做的撮土器具）	差对差；差配差
欢心歌儿唱不完	其乐无穷
獾狼下个小耗子	一辈不如一辈；一代不如一代
还清了房钱	且住
宦官不叫宦官	太贱（监）
换汤不换药	老一套
患的软骨症	没点刚劲
荒山上长高粱	野种
皇帝不称皇帝	孤家寡人
皇帝出宫	前呼后拥
皇帝打架	争天下
皇帝的后代	龙子龙孙
皇帝的交椅	至高无上
皇帝的女儿	不愁嫁
皇帝的女儿招驸马	专拣好的挑
皇帝的圣旨将军的令	变不了；没法变；一口说了算
皇帝剃光头	不要王法（发）
皇帝下圣旨	照办
皇帝做馒头	御驾亲征（蒸）
皇甫讷扮伍子胥	蒙混过关
皇粮国税	免不得
皇上的旨，将军的令	一口说了算
皇上家的祠堂	太妙（庙）
黄柏木下玩瑶琴	苦中作乐
黄柏木做磬槌子	外头体面里头苦
黄表纸包饺子	露馅
黄豆地里带芝麻	点子多
黄豆地里的西瓜	数它大
黄豆碰上热锅	欢蹦乱跳
黄豆切细丝	功夫到家了
黄豆芽炒莲藕	尽钻空子
黄豆芽上天	带尾巴的能豆子
黄豆煮豆腐	父子相会
黄蜂的尾巴	毒极了；最毒
黄蜂叮屁股	有痛讲不出口
黄蜂找窝	乱哄哄
黄蜂锥裤裆	干吃哑巴亏；难出口；苦衷难诉
黄盖挨板子	自讨的；自觉自愿
黄狗当马骑	乱来
黄狗偷食打黑狗	冤枉
黄狗头上出角	尽出洋（羊）相
黄瓜拌辣椒	各有所好；各人所好
黄瓜菜	凉啦
黄瓜当棒槌	越打越短
黄瓜拉秧	塌了架
黄瓜敲锣	去一半；一锤子买卖
黄河的水，长江的浪	源远流长
黄河决了口	滔滔不绝；一泻千里
黄河里的水	难请（清）
黄鹤楼上看翻船	幸灾乐祸
黄鹤楼上看行人	把人看矮了
黄花女作媒	自身难保
黄花鱼下挂面	不用言（盐）
黄昏的燕子	不想高飞
黄昏时的燕子	不想高飞
黄酱掉在裤兜里	不是死（屎），也是死（屎）
黄金能卖高价钱	物以稀为贵
黄连拌苦胆	苦到家了；苦作一堆
黄连拌苦瓜	苦上加苦
黄连拌生姜	辛苦了
黄连打官司	诉苦
黄连雕寿星	苦老头
黄连豆用嘴咬	自找苦吃
黄连炖猪苦胆	苦不堪言
黄连炖猪头	苦了大嘴的
黄连甘蔗挑一担	一头苦来一头甜
黄连锅里煮人参	从苦水中熬过来的
黄连木雕娃娃	苦孩子
黄连木头打娃子	痛苦
黄连木做笛子	苦中作乐
黄连木做图章	刻苦
黄连酿酒	苦打成招（糟）
黄连泡瓜子	苦人（仁）儿
黄连树上挂苦胆	苦相连；一个更比一个苦；苦上加苦
黄连树上结糖梨	甜果都从苦根来
黄连树下吃桂圆	苦中有甜
黄连树下弹琵琶	苦中作乐；苦中取乐
黄连树下喊上帝	叫苦连天
黄连树下一棵草	苦苗苗
黄连树下种苦瓜	苦生苦长
黄连水里泡竹笋	苦透了
黄连水洗脑壳	苦到头了
黄连水洗头	苦恼（脑）
黄连汤淘饭	口口苦
黄毛娃娃坐上席	人小辈大
黄毛鸭子下水	不知深浅
黄泥巴打黑灶	好心不得好报
黄泥巴掉进裤裆里	不是事（屎）也是事（屎）
黄泥巴脚杆子	老实巴脚
黄泥巴做馍馍	土包子
黄泥塘洗单子	拖泥带水
黄牛背上的跳蚤	自高自大
黄牛吃草	吞吞吐吐
黄牛打架	死顶
黄牛脚印水牛踩	一个更比一个歪
黄牛落泥塘	越陷越深
黄牛拴鼻绳	跑不了
黄牛咬黄连	吃苦耐劳
黄貔子（huang pi zi黄鼠狼）唱山歌	没安好心
黄貔子吃鸡毛	填不饱肚子
黄沙搀水泥	合在一起干
黄鳝爆（猛火炒）泥鳅	勾勾搭搭
黄鳝过河滩	不死也要落一身残
黄鳝爬犁头	狡猾（绞铧）
黄鳝遇见泥鳅	滑头对滑头
黄鳝钻洞	顾头不顾腚（出叩臀部）
黄鼠狼拜孤狸	一个更比一个坏
黄鼠狼拜狐狸	一个更比一个坏
黄鼠狼吃鸡毛	填不饱肚子
黄鼠狼抽了筋	浑身哆嗦；直哆嗦
黄鼠狼串门子	到处放臭屁
黄鼠狼戴草帽	充人样；冒充善人
黄鼠狼戴花	臭美
黄鼠狼戴尿罐	晕头转向
黄鼠狼单咬病鸭子	倒霉越加倒霉
黄鼠狼挡汽车	自不量力；不自量
黄鼠狼的腚	放不出什么好屁来
黄鼠狼的脊梁	软骨头
黄鼠狼的脾气	偷鸡摸蛋
黄鼠狼等食	见机（鸡）行事
黄鼠狼吊孝	装蒜
黄鼠狼顶草帽	装文明人
黄鼠狼蹲在鸡窝里	投机（偷鸡）
黄鼠狼躲鸡棚	不是偷也是偷
黄鼠狼给鸡拜年	没安好心；来者不善
黄鼠狼给鸡送礼	不怀好意
黄鼠狼给鸡做笑脸	没安好心
黄鼠狼过闹市	人人喊打
黄鼠狼过泥塘	小手小脚
黄鼠狼过水田	拖泥带水
黄鼠狼和狐狸结亲	臭味相投
黄鼠狼间难卦	凶多吉（鸡）少
黄鼠狼见了鸡	眼馋
黄鼠狼借鸡	有借无还
黄鼠狼进鸡窝	灾难临头；没安好心；无孔不入；有空就钻
黄鼠狼进宅	来者不善
黄鼠狼看鸡	越看越稀
黄鼠狼烤火	爪干毛净
黄鼠狼啃乌龟	找不到头；无从下口
黄鼠狼拉骆驼	不识大体
黄鼠狼拉小鸡	有去无回
黄鼠狼立在鸡棚上	不是你也是你
黄鼠狼骂狐狸	对坏；都是骚（臊）货
黄鼠狼觅食	见机（鸡）行事
黄鼠狼泥墙	小手小脚
黄鼠狼排队	一路骚（臊）货
黄鼠狼偷鸡	专干这行的
黄鼠狼吞鸡毛	填饱肚子就行
黄鼠狼拖牛	自不量力；大干一场
黄鼠狼拖着鸡毛掸	白欢喜；空喜一场
黄鼠狼戏水牛	大的没有小的能
黄鼠狼下刺猬	一窝不如一窝
黄鼠狼咬病鸭子	浑身打哆嗦
黄鼠狼咬刺猥	无从下口；难下口
黄鼠狼专咬病鸭子	倒霉透了；真倒霉
黄鼠狼钻鸡笼	想投机（偷鸡）
黄鼠狼钻磨坊	充大耳朵驴
黄鼠狼钻水沟	各走各的路
黄鼠狼钻烟囱	越钻越黑
黄鼠狼钻阴沟	各走各的路；各行各的道
黄鼠狼钻灶	毛干爪净；火烧火燎
黄鼠狼嘴下溜出的鸡	死里逃生
黄鼠狼嘴下逃出的鸡	好运气
黄头鸟（金丝鸟）搭窝	得过且过
黄土捏泥人	你中有我，我中有你
黄杏熬北瓜（南瓜）	一色货
黄羊的尾巴	长不了
黄羊跑到虎穴里	凶多吉少
黄忠出阵	不服老
黄忠交朋友	人老心不老
黄忠叫阵	不服老；不甘示弱；老当益壮
黄忠抡大锤	老当益壮；不服老
黄忠射箭	百发百中
会计戴眼镜	精打细算
会计上门	找你算帐
豁牙子拜师傅	无耻（齿）之徒
豁牙子啃西瓜	道道多
豁牙子啃猪蹄	横扯筋
豁子吵嘴	谁也别说谁
豁子喝米汤	无耻（齿）下流
豁子嘴照镜子	当面出丑
豁嘴吹灯	白费劲
豁嘴罐子打水	放任自流
饥饿送口粮	帮了大忙
饥了吃花生	生吞活剥
机关枪打飞机	水平提高了；派错了用场；抬高自己，打击别人
机关枪打炮弹	不对口径
机关枪打兔子	小题大做
机关枪对炮筒	直性子对直性子（比喻性情直爽的人相遇，非常对劲：）
机关枪瞄大炮	直性子对直性子
机关枪上刺刀	连打带刺
机关枪伸腿	两岔
机器人打拳	全是硬功夫
机器人打铁	硬对硬
机器人讲情话	有口无心
机器人看戏	无动于衷
鸡抱鸭蛋	一场空；白操心
鸡长牙齿蛋生毛	天下奇闻；无奇不有
鸡肠上刮油	有也不多
鸡肠子上刮膏	没多大油水
鸡巢里的凤凰	至高无上
鸡吃放光虫（萤火虫）	肚里明
鸡吃胡豆	够戗（够受的）
鸡吃黄鼠狼	怪事一桩；怪事
鸡穿大褂狗戴帽	衣冠禽兽
鸡戴帽子	官（冠）上加官（冠）
鸡蛋长爪子	能滚能爬
鸡蛋炒韭黄	色货
鸡蛋炒鸭蛋	各自打散；混蛋
鸡蛋掉油缸	圆滑
鸡蛋放在碓窝（dui wo石臼）里舂	捣蛋
鸡蛋和西瓜	经不起摔打
鸡蛋换鸭蛋	捣（倒）蛋
鸡蛋换盐	两不见钱
鸡蛋壳上找缝	白费功夫；枉费功；白费劲
鸡蛋壳做线板	难缠
鸡蛋筐里放秤砣	砸啦
鸡蛋里面找骨头	百般挑剔
鸡蛋里淌水	坏蛋
鸡蛋里挑骨头	无中生有；故意找茬（碴）儿
鸡蛋碰石磙	不是对手
鸡蛋碰石头	自不量力；不堪一击；粉身碎骨；自取灭亡
鸡蛋上刮毛	痴心妄想
鸡蛋生蛆	肚里坏；坏蛋
鸡蛋喂老虎	囫囵（hu lun完整；整个儿）吞
鸡蛋下山	滚蛋
鸡蛋走路	滚蛋
鸡斗黄鼠狼	自己找死；寻死；送死
鸡孵鸭子	白忙活
鸡给黄鼠狼拜年	自投罗网
鸡公屙（e 排泄）屎	又臭又硬；臭硬；头节硬
鸡公头上的肉	大小是个官（冠）
鸡狗做邻居	老死不相往来
鸡骨头熬汤	没多大油水
鸡叫走路	越走越明
鸡笼里过日子	一身的窟窿（比喻欠债多，到处是债主。）
鸡笼里睡觉	睁眼净窟窿
鸡毛插在桅杆上	胆（掸）子不小；好大的胆（掸）子
鸡毛炒韭菜	乱糟糟
鸡毛打鼓	不声不响；无声无息
鸡毛掸沾水	时髦（湿毛）
鸡毛掸子	尽招灰
鸡毛点灯	十有九空
鸡毛掉井里	不声不响
鸡毛搁秤盘	没分量
鸡毛过大秤	没有份量
鸡毛落水	毫无反响
鸡毛敲钟	不想（响）；没回音
鸡毛上天	轻飘
鸡毛性子	一点就着
鸡毛与蒜皮	微不足道；没多少斤两；微乎其微
鸡毛遭风吹	身不由己；不由自主
鸡梦见小米	尽想好事；；想得倒美
鸡拿耗子猫打鸣	乱套了
鸡脑壳安在鸭颈上	不对头
鸡碰蜈蚣	死对头
鸡屁股里掏蛋	急性子
鸡屁股拴绳	扯淡（蛋）
鸡婆抱鸭子	舍己为人
鸡婆跳进火坑	不死也要脱层毛
鸡群里闯进一只鹅	就你脖子长
鸡群里的仙鹤	高人一头；身高气傲
鸡食盆里的鸭子	多嘴多舌
鸡屎蛋子塑神像	胎里坏；坏了胎
鸡屎蚊子打哈欠	好大的气魄
鸡屎蚊子戴眼镜	架子不小；好大的架子
鸡随鸡，狗随狗	臭味相投
鸡头伸进猪食槽	插不上嘴；难插嘴
鸡腿煮豆腐	一勺烩
鸡尾巴上拴扫帚	好伟（尾）大
鸡窝里的凤凰	至高无上
鸡窝里飞出金风凰	异想天开
鸡窝门口贴对联	小题大做
鸡窝斟（tiao调换）鸭窝	差不离
鸡衔骨头	替狗累
鸡遇黄鼠狼	胆战心惊；命难逃
鸡爪上钉掌子	不对题（蹄）
鸡爪子炒菜	七拱八翘
鸡捉耗子	乱了套
鸡啄闭口蚶	白张嘴；白费功夫
鸡子儿（鸡蛋）碰碌碡（liu zhou石磙）	完蛋
鸡子儿长爪子	滚的滚，爬的爬；连滚带爬
鸡子儿下坡	滚蛋
积木搭高楼	一推就倒；一碰就倒
积木搭墙	一推就倒
积木砌房子	一碰就倒
畸形人做衣服	另搞一套
急惊风碰着个慢郎中	干着急
急救车碰上了救火车	急上加急
急救车撞了救火车	急上加急（比喻特别紧急）
急刹车摔倒	身不由己
急水滩里的鹅卵石	磨掉了棱角
急水滩头的大鲤鱼	经过风浪
急水滩头的大鱼	经过风浪
急水滩头放鸭子	一去不复还；一去不回头（比喻没有回音）
急性子动手	说干就干
急性子碰到慢性子	你急他不急
急性子作客	说来就来
急需的图章	刻不容缓
集市上买东西	挑挑拣拣
蒺藜（ji li一年生草本植物。果皮有尖刺）拌草	不是好料
蒺藜上弹棉花	越整越乱
蒺藜窝里睡觉	浑身不自在
几百年的老陈账	难算；算不清
挤虮子（ji zi虱子的卵）的血都要舔	吝啬鬼
脊背长疮，胸口贴膏药	不顾后患
脊背上背鼓	找着挨锤；找锤
脊梁长疮，胸口贴膏药	不顾后患
脊梁骨长茄子	多心；生了外心
脊梁骨上长茄子	生了外心
麂子（ji zi麂。一种小型的鹿）给老虎拜年	没有好下场
妓院里的处理品	下贱货
既保娘娘，又保太子	两全其美
既会杀猪，又会做饭	多面手
济公吃狗肉	不管清规戒律
济公当和尚	不吃素
济公的扇子	神通广大
济公的装束	衣冠不整
济公过日子	只讲吃不讲穿
济公治病	主动上门
济公走路	疯疯癫癫
寄生虫享福	室（qing享受）吃窒喝
夹道里摆酒席	口上热闹
夹道里截驴	没有回头的余地
夹道里推车子	直出直人；进退两难；直来直去
夹火钳子	一头热
夹子上的老鼠	没跑；跑不了
家里丢了磨	没法推
家雀熬汤	没肉也香
家雀变凤凰	越变越俏；尽想好事；想得倒美
家雀儿吵嘴鸡打架	无人管
家雀进笼子	有翅难飞
家雀学老鹰	想得高
家神揍灶神	自家人打自家人
甲鱼吃木炭	黑心王八
甲鱼翻跟头	四脚朝天
贾宝玉爱林妹妹	好梦难圆
贾宝玉出家	看破红尘
贾宝玉的通灵玉	命根子
贾宝玉结婚	不是心上人
贾宝玉看《西厢记》	戏中有戏
贾宝玉看林妹妹	见如故
贾府的大观园	外强中干
贾府门前的狮子	死心眼（石心眼儿）
贾家姑娘嫁贾家	假（贾）门假事（贾氏）
驾驶员罢工	想不开
驾辕的马驹尥蹶子（liao jue zi）	乱了套
架车登山	不进则退
架起砧板就切菜	说干就干
架上的葫芦	挂起来；挂着
架着的锅，点着的火	样样现成
假李逵碰真李逵	冤家路窄
假期做梦	休想
嫁不出去的闺女	成了老大难
嫁出去的女儿泼出去的水	收不回来
嫁接的果树	节外生枝；横生枝节
奸狼下了个贼狐狸	不是好种；孬（咖坏；不好）种
尖扁担挑水	心挂两头
尖底箩筐	不稳当；不稳
尖尖筷子夹凉粉	滑头对滑头
肩膀上搭炉灶	恼《脑）火
肩膀上生疮	担当不起；挑不起重担；难挑担
肩头上放花炮	祸（火）在眼前
监狱门上的匾	悔之莫及；后悔已晚
缄门头上挂猪肝	少心没肺
煎过三遍的药	无用之物；废物
煎过三遍的药渣	早该倒了
捡风筝丢云雀	得不偿失
捡个孩子唱大戏	看你庆哪家的功
捡根鸡毛当令箭	谁听你的
捡来的媳妇	不美满
捡了芝麻甩了西瓜	因小失大
剪开个蚕茧贴在眼上	满眼都是丝（私）（比喻极端自私自立。）
剪了翅膀的八哥	看你还能飞上天
见到熟人握握手	你好我也好
见高就拜，见低就踩	势利眼
见狗扔骨头	投其所好
见惯了骆驼	看不出牛大来（比喻眼光太高）
见了苍蝇都想扯条腿	贪得无厌；贪心不足
见了苍蝇撕条腿	贪得无厌
见了大官叫舅	高攀
见了官老爷叫舅	高攀
见了和尚叫舅子	乱认亲
见了皇帝喊万岁	老规矩
见了火的蜡烛	软了；软不拉耷
见了舅爷叫姨父	看错了人；认错了人
见了骆驼说马肿背	少见多怪
见了麦苗叫韭菜	五谷不分
见了猫就怕	胆小如．鼠
见了强盗喊爸爸	认贼作父
见了寿衣也想要	贪心鬼
见了兔子才放鹰	有利才出征（比喻对自己没利的事不干。）
见了外公叫爹爹	不识相
见了王母娘娘喊岳母	想娶个天仙女（比喻想娶个美丽非凡的妻子。）
见了王母娘娘叫大姑	妄想；想沾点仙气；攀高亲（比喻巴结比自己地位高的人。）
见了蚊子就拔剑	大惊小怪
见了县官喊姑爷	乱巴结
见了丈母叫大嫂	乱了班辈；昏头昏脑；昏了头
见人扯媚眼	卖弄风流
见人先作揖	礼多人不怪
见啥菩萨烧啥香	看人行事
见钟不打铸钟敲	舍近求远
见着骆驼不说蚂蚁	光拣大的说
建昌鸭子	好硬的嘴；嘴硬
毽子毛	尽在钱上站着
毽子上的鸡毛	钻进钱眼里了
箭头离了弦	勇往直前
箭在弦上	一触即发
箭猪钻刺篱笆	刺对刺
江边插杨柳	落地生根
江边开染房	大摆布
江边卖水	多此一举；没事找事
江边上洗萝卜	一个个来（比喻按次序地进行。）
江河发大水	后浪推前浪；一浪高一浪
江河里长大水	泥沙俱下
江湖佬的膏药	不知真假
江湖佬卖假药	招摇撞骗
江湖佬卖完狗皮育	该收场了
江湖佬耍戏法	说变就变；转眼就变；变化无常
江湖卖艺的	摊子不大，喊声连天
江湖骗子卖药	有假无真；冒牌货
江湖骗子耍贫嘴	夸夸其谈
江里的浪花	不是吹的（比喻不是说大话所能办到的。）
江里的木偶	随大流
江南的蛤蟆	难缠（南蟾）
江心断了帆桅	转了向
姜太公的眼镜没镜片	老框框
姜太公钓王八	愿者伸脖子
姜太公钓鱼	愿者上钩
姜太公说相声	神聊
姜太公算卦	好准啊
姜太公坐主席台	资格老
姜子牙的坐骑	四不像
姜子牙开算命馆	买卖兴隆
姜子牙娶媳妇	老来喜
将军不下马	各奔前程
将军返乡	解甲归田
将门出虎子	一代更比一代强；一辈强似一辈
僵蚕放在蚕蔟上	一丝不挂
僵蚕做硬茧	不成功（宫）
讲话没人听，下令没人行	光杆司令
讲课还是老一套	屡教不改
讲台上的花盆	装饰品
讲台上放花盆	摆设；装饰品
讲武堂里学打仗	纸上谈兵
奖状绑在笤帚上	名誉扫地
蒋干盗书	上了大当
耩（jiang）地看耧眼	走着瞧
降不住猪肉降豆腐	欺软怕硬
酱菜店里的抹桌布	尝尽辛酸
酱菜缸里的瓜子	闲人（仁）
酱菜缸里泡石头	一言（盐）难尽（进）
酱坊里开除的伙计	闲（咸）人
酱缸腌时子	亲（咸）肉一块
酱坛里装个鳖	亲员（咸圆）
酱油店里打架	争风吃醋
糨糊锅里煮扳不倒（不倒翁）	混（浑）小子
糨糊洗脸	头脑不清
浇地扒垄（long）沟	捅漏子
胶皮轱辘（gu lu车轮）放炮	气炸了；气崩了
胶皮笊篱（zhao li捞取东西的用具。用金属丝、竹蔑或柳条等编成。有长柄）	滴水不漏
蛟龙困在沙滩上	翻不了身；难翻身；威风扫地；抖不起威风
跤龙困在沙滩上	威风扫地
跤龙头上搔痒	溜须不要命
狡兔撞鹰	以攻为守
饺子开口	露馅了
饺子烂了边	露馅
饺子皮太薄	难免要露馅
饺子破皮	漏了馅（比喻事情暴露了。）
饺子铺的酱油	白搭
饺子脱皮	露了馅
脚板上长鸡眼	寸步难行
脚板上扎刺	存心不让走
脚脖子上把脉	瞎摸
脚脖子上挂铜铃	走一路，响一路
脚踩棒槌，头顶西瓜	两头耍滑
脚踩棒槌	立场不稳
脚踩两只船	三心二意。
脚踩棉花堆	不踏实；腾云驾雾
脚踩牛屎	一塌糊涂
脚踩西瓜皮，手里抓把泥	一溜二抹；滑的滑，溜的溜
脚长鸡眼臀生疮	坐立不安
脚戴帽子头顶靴	上下不分
脚登黄山，眼望峨眉	这山望着那山高
脚蹬鼻子	上脸
脚底板儿抹油	溜得快；溜啦
脚底板上绑大锣	走到哪，响到哪
脚底长疮	寸步难行
脚底下踩棒槌	立场不稳；站不稳
脚夫的腿，说书的嘴	练出来的
脚后跟拴秤砣	进退两难
脚后跟拴藤条	拉倒
脚面上长眼睛	自看自高
脚盆里撑船	内行（航）
脚上穿袜，头上戴帽	老一套
脚上戴帽子	乱了套
脚上的泡	自己走的
脚踏车挂飞轮	快上加快；飞快
脚踏车撵（nian追赶）汽车	望尘莫及
脚踏擀面杖	立场不稳；左右摇摆；摇摆不定；不稳当
脚踏两只船	左右摇摆；摇摆不定；三心二意；进退两难
脚踏楼梯板	步步高升；步步登高
脚像钉耙，手像蒲扇	大手大脚
脚丫子抓痒痒	你算哪把手
脚趾缝里长茅草	慌（荒）了手脚
叫跛子撵（nian追赶）狼	强人所难
叫花子（乞丐）挨骂	淘（讨）气
叫花子摆阔气	穷大方
叫花子搬家	一无所有
叫花子抱着醋坛子	穷酸
叫花子拨算盘	穷有穷打算
叫花子吃豆腐	一穷二白
叫花子吃狗肉	块块好
叫花子吃葡萄	穷酸
叫花子打狗	一手功夫；边打边走
叫花子打哈哈	其乐无穷
叫花子打架动刀子	穷凶极恶；穷横
叫花子打了碗	倾家荡产
叫花子戴眼镜	穷讲究；穷打扮
叫花子当老板	阔啦；阔气了
叫花子的打狗棒	穷棒子；穷棍
叫花子登榜	人不可貌相
叫花子跌在石灰堆里	一穷二白
叫花子赶集	场场不缺
叫花子赶街	分文没有
叫花子嫁长工	穷对穷；一对穷
叫花子进贡	穷尽忠
叫花子看滑稽（独角戏）	穷开心
叫花子看外婆	两手空
叫花子啃猪蹄	津津有味
叫花子拉二胡	穷扯；穷快活；穷作乐
叫花子练跌打	穷折腾
叫花子亮相	穷相毕露
叫花子碰上大雪天	饥寒交迫
叫花子起五更	穷忙
叫花子请客	穷张罗；穷大方
叫花子晒太阳	享天福
叫花子上坟	哭穷
叫花子睡觉	穷困
叫花子睡凉亭	穷风流
叫花子讨饭	只图多
叫花子讨灰面（面粉）	一穷二白
叫花子跳井	穷途末路；无路可走
叫花子胸前挂钥匙	穷开心
叫花子要黄连	自讨苦吃
叫花子遇神仙	比不上
叫花子照镜子	一副穷相；穷相
叫花子捉虱子	十拿九稳
叫花子走人户（走亲戚）	两手空
叫花子坐金銮殿	一步登天
叫花子做驸马	受宠若惊
叫花子做皇上	喜从天降
叫林黛玉抡板斧	强人所难
叫驴变成土蚂蚱	一辈不如一辈；一代不如一代
叫你上坡，你偏下河	成心闹别扭；专找别扭；故意捣乱
叫牛坐板凳	办不到；没法办，
叫铁公鸡下蛋	异想天开
叫铁匠做嫁妆	用人不当
叫兔子去拉磨	没有那一套
叫哑巴唱歌	强人所难
叫羊看菜园	越看越光
轿子进了门，不见新媳妇	人财两空
轿子里打拳	不识抬举
教观音菩萨识字	枉费心机
教猴子爬树	多此一举
教菩萨认字	枉费心机
教堂关门	不讲道理
接彩球的乞丐	高兴得发傻
街道司衙门	唬得过谁
街上的传单	白给
街头的狗	谁有吃就跟谁走
街头上耍把戏	说得多
街头耍把势	光说不练
节日的礼花	万紫千红
节日放烟火	天花乱坠
结巴郎吵架	张口结舌
结清了的账单	一笔勾销
截了大褂补裤子	取长补短
姐儿俩害相思	同病相怜
姐儿俩相（xiang）女婿	各有所爱；各人所爱
姐俩出嫁	各得其所
姐俩回娘家	殊途同归
姐俩找婆家	各走各的路；各行各的道
芥末（调味品。味辣）拌凉菜	各有所爱
借米还糠	气鼓气胀；气鼓鼓
借票子做衣服	浑身是债
借钱还债	堵不完的窟窿
借钱买筛子	窟窿套窟窿
借他的缰绳拴他的驴	将计就计
借汤下面	沾光；顺便
借债买藉吃	窟窿套窟窿
今年竹子来年笋	无穷无尽
今日三，明日四	反复无常
金棒槌敲门	富啦
金蝉脱壳	溜啦；干净利索
金弹打飞鸟	因小失大
金弹子打鸟	得不偿失
金刚倒地	一摊泥
金刚化佛	更神气
金刚石上镶宝石	好上加好
金刚石钻钻瓷器	一个比一个硬；硬过硬
金刚石做钻头	无坚不摧
金刚拖地板	有劳大驾
金刚掌钥匙	大管家
金刚钻儿包饺子	钻心痛
金刚钻划豆腐	深刻
金刚钻锔大锅	没有钻不透的
金刚钻钻瓷器	一个硬似一个
金刚钻钻缸瓷	大的没有小的能；小能降大
金瓜对银瓜	两个顶弧呱
金瓜换银瓜	越换越差
金龟子掉到酱缸里	糊涂虫
金鸡配凤凰	天生的一对
金壳郎（金龟子）赶牛	自不量力；不自量
金銮殿上的狗尿苔	色不济，长在好地方
金銮殿上告王子	自讨苦吃
金漆的马桶	外面光，里面臭；外面好看里面臭
金漆马桶	外面光，里面臭
金碗盛稀饭	装贱
金鱼缸里放泥鳅	看你怎么耍滑头
金鱼缸里钻泥鳅	看你怎么耍滑
金鱼喂猫	不上算；不合算
金簪（zan）人海	永无出头之日；难出头
金簪落海	无出头之日
金针菜开花	到顶了
金针菜喂骆驼	不够本钱；不够本
金针对钻头	一个比一个尖；尖对尖
金铸的孩童	好人才
金铸的鞋模	好样子
金子当做黄铜卖	屈才（财）
紧着裤子数日月	日子难过
锦鸡进铁笼	身不由已；不由自主
锦鸡扑火	自取灭亡
妗子（jin zi舅母）改嫁	没救（舅）
近视眼穿针	大眼瞪小眼
近视眼打靶	目的不明
近视眼戴眼镜	各投各眼；各对各眼
近视眼过独木桥	小心在意；只顾眼前；迈不开步子
近视眼配眼镜	解决眼前问题
近视眼瞧卒	不象个事（士）
进冰场穿冰鞋	马上就溜
进港的轮船	不怕风浪
进了地府才后悔	来不及了；迟了
进了棺材吃人参	无补
进了套的黄鼠狼	没跑；跑不了
进网的黄花鱼	离死不远
进网的兔子上钩舶鱼	十拿九稳
进屋跳窗户	门路不对
进学堂不带书	忘本
浸了水的爆竹	一声不响
浸了水的大鼓	打不响
浸了水的鼓皮	不想（响）了
浸湿的木头	点不起火
浸水的麻花	不干脆
浸水的木鱼	敲不响
浸水的炮仗（爆竹）	不声不响；无声无息
京戏演唱《白毛女》	别开生面
京戏走台步	慢慢挪；慢慢蹭
泾渭合流	清浊分明
荆轲刺秦王	图穷匕首见
荆轲献地图	暗藏杀机
荆条编小篮	看着容易做着难
惊弓之鸟	心有余悸；远走高飞
惊险小说	危言耸听
惊蛰后的长虫	势起来
惊蛰后的青竹蛇	越来越凶
惊蛰后的青竹索	越来越凶
惊蛰后的蜈蚣	越来越凶
精雕的玉人	十全十美
井底吹喇叭	低声下气
井底的蛤蟆	目光短浅
井底的蛤蟆上井台	大开眼界
井底丢砖头	不懂（扑通）
井底青蛙	没见过世面；不知天高地厚
井底下放炮	有原因（圆音）
井底下划船	前途不大；走不出小圈子
井底下看书	学问不浅
井底下写文章	学问不浅
井底下种花生	根底深
井底行船	处处碰壁
井底栽黄连	苦得深
井里长了一棵树来	根子深
井里打水往河里倒	胡折腾
井里的吊桶	任人摆布；由人摆布
井里的蛤蟆酱里的蛆	把你没看在眼里；算不了什么；自来的
井里投砒霜（pi shuang砷的氧化物。剧毒）	害人不浅
井水不犯河水，南山不靠北山	各过各的
井台上的辘轳（lu lu）	摇摇摆摆
景德镇停业	没词（瓷）了
警察打他爹	公事公办
警察当扒手	知法犯法
警察蹲监狱	以身试法
警犬的鼻子	真奸（尖）
敬酒不吃吃罚酒	不知好歹；不识抬举
镜中花，水中月	空好看；可望而不可即
镜子里的饼	不能充饥
镜子里的烧饼	不能充饥
镜子里的鲜花	空好看；好看不好拿
镜子里的馅饼	中看不中吃；好看不能吃
镜子里骂人	自骂自
镜子里亲吻	人家不亲自己亲
镜子里亲嘴	别人不亲自己亲
镜子上的人儿	挺光滑的
揪下茄子拔了秧	连根收拾
揪着耳朵过江	操心过度（渡）
揪着马尾巴赛跑	悬
揪着马尾赛跑	玄（悬）
九寸加一寸	得寸进尺
九个鸡蛋掉地上	四分五裂
九个瓦盆摔山下	四分五裂
九股绳拧成死疙瘩	难分难解
九斤老太（鲁迅小说《风波》中的人物）的口头禅	一代不如一代
九斤老太的眼光	光看过去的好
九牛爬坡	个个使劲；个个出力
九牛失一毛	不在乎；无足轻重；无关紧要；无关大局
九牛一毛	微不足道；微乎其微
九曲桥上扛竹竿	难转弯；转不过弯来
九曲桥上散步	走弯路；拐弯抹角
九曲桥上拖毛竹	拐弯抹角；难过
九死一生的幸运儿	死去活来
九岁当了童养媳	活受罪
九条江河流两处	五湖四海
九月的寒霜，二月的风	长不了
九月的柿子	红透了；软不拉耷（da下垂）
九月菊花逢细雨	点点人心
久旱得雨	喜从天降
久旱逢甘雨	人人欢喜；个个喜爱
韭菜拌茴香	一团糟
韭菜炒蒜苗	清（青）一色
酒杯里量米	小气（器）
酒杯里洗澡	小人
酒杯碰酒壶	恰好一对
酒鬼掉进酒池里	求之不得
酒鬼喝汽水	不过瘾
酒鬼走路	东倒西歪
酒壶当夜壶用	派错了用场
酒壶里插棒棒	胡（壶）搅
酒肉和尚菜道士	岂有此理
酒坛子当夜壶	大材小用
酒醒不见烤牛肉	悔之莫及；后悔已晚
酒糟鼻不吃酒	枉担虚名
酒糟炒鸡蛋	吵（炒）个稀巴烂
酒盅里拌黄瓜	施展不开
旧抹布补新衣裳	配不上；不配
旧鞋踏狗屎	提不得；提不起来；别提了
臼间老鼠	嘴尖牙利
臼鼠拖南瓜	咋办
臼鼠走亲戚	土来土去
救火没水	干着急
救火踢倒煤油罐	火上加油
就坡骑驴	好下台阶；自找台阶
就着猪肉吃油条	腻透了
舅舅揍外甥	白挨
舅老爷请春客	奉陪到底
锔（ju 用锔子连合破裂的陶瓷器等）碗的戴眼镜	专找茬（碴）儿
举起碾盘打月亮	不知天高地厚
举世无双的珍宝	独一无二
举着棋子放不下	拿不定主意；打不定主意
锯大树当镰把	大材小用
锯子解高粱秆	小题大做
锯子锯掉烂木头	摧枯拉朽
卷好铺盖，买定草鞋	决心出走
卷舌头念文章	含糊其辞；含含糊糊
撅着屁股看天	有眼无珠
决了堤的河水	横冲直撞；挡不住；滔滔不绝
决了堤的水	横冲直撞
决了口的水渠	放任自流
绝户头得个败家子	明看不成器，丢又舍不得
绝户头生对双生子	陡增欢喜；后继有人
嚼过的甘蔗	不甜
嚼过的馍馍	没味道
嚼烂舌头当肉吃	自吃自；自欺欺人；自己哄自己
嚼着甘蔗上楼梯	节节甜，步步高
军号嘴上贴胶布	吹不响
军棋比赛	纸上谈兵
军事论文	纸上谈兵
君子不犯法坐班房	白挨
俊姑娘脸上一块疤	美中不足
俊女嫁痴汉	可惜；真可惜
骏马跑千里，银燕入云霄	远走高飞
骏马驮银鞍	两相配
卡车的拖斗	老落后；落后了
卡壳的卡宾枪	打不响
开春的柳絮	满天飞
开春的鸟儿	成双成对
开春的兔子	成群结伙
开刀不上麻药	蛮干；硬干
开灯聊天	说亮话
开饭馆不怕大肚汉	越多越好
开饭馆的卖百货	有吃有用；用吃有穿
开封府的包公	铁面无私
开封府的包青天	铁面无私
开弓不放箭	跃跃欲试；虚张声势
开弓的箭	永不回头；决不回头
开沟挖井	层层深入
开棺验尸	追查到底
开河塌了堤	难收场；收不了场
开花的白菜	起了心
开花期遇暴雨	结果不好
开会差半点	知道迟到了
开会呼口号	异口同声
开会骂仗	不欢而散
开会请了假	没出席（息）（比喻没有什么前途，可没有长进。）
开局摆开拦河车	严阵以待
开局的兵卒	作用不大
开了瓶的啤酒	好冲
开了锁的猴子	得意忘形；无拘无束
开了闸的河水	一泻千里
开了闸的水库	滔滔不绝
开笼放麻雀	各奔前程
开笼放鸟	有去无回
开汽车按喇叭	靠边站；走到哪，响到哪
开山放瞎炮	不想（响）
开水灌鼠洞	一窝都是死
开水锅里的汤圆	翻上倒下
开水锅里揭奶皮	白费功夫；白费劲；万万办不到
开水锅里捞红鱼	荒唐
开水锅里露头	熟人
开水锅里伸胳膊	熟手；手熟
开水锅里洗澡	熟人
开水锅里煮空笼	不争（蒸）饱子争（蒸）口气
开水锅里煮寿星	老熟人
开水里捞肥皂	全凭手快
开水泡黄豆	自大；自我膨胀
开水泼蛤蟆	看你怎么跳
开水泼老鼠	不死也要脱层皮
开水烫泥鳅	看你怎么耍滑；直脖啦
开水碗上的葱花	华（花）而（儿）不实
开水洗脸	难下手（比喻不得下手。）
开水煮白玉	不变色（比喻有胆量。或很有骨气。）
开水煮棉絮	熟套子
开闸的洪水	畅通无阻
开着电扇聊天	尽讲风凉话
开着收音机听戏	闻声不见人（比喻只听到名声，没有见到人。）
开着拖拉机撵兔子	有劲使不上（比喻有本事、才能，但因条件所限施展不开。）
凯旋而归的将军	大功告成
砍不倒大树	弄不多柴禾（比喻做事不能怕困难，要看效果。）
砍柴刀刮脸	手艺高；冒险；危险；好险
砍柴人下山	两头担心（薪）
砍柴忘带刀，刨地不带镐	丢三落（la）四
砍倒苞谷（玉米）露野猪	藏不住
砍倒大树捉鸟	呆子；傻干
砍倒的柳树	死不甘（干）心
砍倒树捉麻雀	小题大做
砍断的竹子	接不上
砍树吃桔子	不顾根本
砍树吃橘子	不顾根本
砍树的砍树，劈柴的劈柴	各尽其责；各尽其职
看《红楼梦》淌眼泪	同病相怜
看《三国》掉泪	替古人担忧
看病先生开棺材铺	死活都要钱（比喻不讲情面。）
看到草绳就喊蛇	大惊小怪
看到草绳往后跑	胆子太小
看到金子变成铜	怪事一桩；怪事
看惯了武打片	不怕你搞小动作
看家狗专咬叫花子（乞丐）	穷人好欺负
看家拳头	留一手
看见官老爷叫舅子	想高攀
看见和尚喊姨夫	乱认亲
看见和尚叫舅子	乱认亲
看见麦苗叫韭菜	五谷不分
看见尼姑喊嫂子	乱认亲
看见外公叫爷爷	不识相
看见岳父不搭腔	有眼不识泰山
看门的神仙	管不了庙里事
看人上菜	势利眼
看人挑担	不费力；不费劲；不吃力
看人跳崖不阻挡	见死不救
看人下菜碟	势利眼
看戏的掉眼泪	替古人担忧
看戏流眼泪	假慈悲；假慈善
看戏挑媳妇	一头满意（比喻一方面心里满足）
看羊的狗	一个比一个凶
看衣裳行事	狗眼看人
看准洞儿捉黄鳝	没跑；跑不了
看着查声肚子疼	哭笑不得
看着地图摆阵势	纸上谈兵
看着天摸着地	眼高手低
看着天说话	不知眼多高；不知眼有多高（比喻要求的标准高）
看着星星想着月亮	贪得无厌；贪心不足
看着帐本聊天	说话数数
康熙替父还债	碗（晚）了
糠里挤油	小抠
糠了的萝卜	没有辣气（比喻对手或敌人没有多大力量了。或不那么厉害了。）
糠筛筛了用绢筛	真细
糠心儿的萝卜	蔫（nian不声不响；悄悄地）坏
扛犁头下关东	经（耕）得多
扛磨盘游华山	苦尽心
扛鱼网进庙堂	劳（捞）神
扛着风箱串门子	给别人添气受
扛着棍去挨打	自讨苦吃
扛着鸡毛换肩	不知轻重
扛着救生圈过河	小心过度（渡）
扛着碌碡（liu zhou石磙）撵（nian追赶）兔子	不分轻重缓急
扛着鸟枪上疆场	抵挡一阵
扛着牌坊卖肉	架子不小；好大的架子
扛着瘙头（jue tou刨土用的农具）上土地庙	糟踏神像
炕上种南瓜	没人见过；没有的事
炕屋里的鸡蛋	不攻自破
炕席上下棋	无路可走
考上秀才盼当官	欲无止境
考上秀才想当官，登上泰山想升天	贪得无厌；贪心不足
烤炉火吹电扇	冷热结合
烤熟了的羊头	龇牙咧嘴
靠山吃山，靠水吃水	一方水土养一方人
靠小姨荞孩子	指望不上
坷垃（土块）地里撵（nian追赶）瘸子	跑不了；没跑
瞌睡碰着枕头	求之不得
瞌睡送个枕头	正是时候
磕完头撒供	留神
磕一个头放三个屁	行好没有作孽多
蝌蚪变青蛙	有头无尾
蝌蚪的尾巴	寿命不长
蝌蚪跟着乌龟跑	硬充王八的孙子
蝌蚪害头疼	混身是病
客气碰着老实	虚情当成真意（比喻把假的当成了真的。）
嗑瓜子吃核桃	不能不求人（仁）
嗑瓜子瞌出个臭虫	充人（仁）来了
嗑瓜子嗑出个臭虫来	什么仁（人）儿都有
嗑瓜子嗑出虾米来	遇上了好人（仁）
啃着鱼骨聊天	话中带刺
空城计退敌	反败为胜
空袋子	立不起来
空肚子打饱隔	硬撑市面
空手进衙门	非输不可
空手跑进中药店	没方子
空手挖萝卜	一个个地提拔
空手抓白鱼	难得（逮）
空心罗汉	没肚量；无心肝（比喻没有心计，或没有感情。）
空心萝卜	中看不中用（比喻外表看起来不错，但没有一点用处。）
空中飞人	上不着天，下不着地
空着手回娘家	无理（礼）
孔方兄进庙门	钱能通神
孔夫子搬家	净是书（输）（比喻总是失败。）
孔夫子的背包	准是书（输）（比喻注定要失败。）
孔夫子的褡裢（da lian中间开口的长方形口袋。两端各成一个袋）	两头输（书）；书呆（袋）子
孔夫子的弟子	闲（贤）人
孔夫子的手巾	包输（书）
孔夫子的箱子	净输（书）
孔夫子的砚台	黑心
孔夫子的嘴巴	出口成章
孔夫子挂腰刀	能文能武；文武双全
孔夫子喝卤水	明白人办糊涂事
孔夫子讲学	之乎者也
孔夫子门前卖《论语》	自不量力；不自量
孔夫子面前讲《孝经》	假斯文；冒充斯文
孔夫子念书	咬文嚼字（比喻过分地斟酌词句。）
孔夫子念文章	咬文嚼字
孔夫子偷钱包	文明人不做文明事
孔夫子游列国	尽是礼
孔明大摆空城计	化险为夷
孔明的计谋	神机妙算
孔明会李逵	有敢想的，有敢干的
孔明加子龙	智勇双全
孔明借东风	巧用天时
孔明夸诸葛	自夸
孔明练琴	老生常谈（弹）
孔明用计	神机妙算
孔雀戴凤冠	官（冠）上加官（冠）
孔雀的尾巴	翘得高
孔雀开屏	翘尾巴；尾巴翘得高
孔雀耍掸帚	出计不出面
孔雀头上绑鸡毛	一语（羽）双关（冠）
孔雀遇凤凰	比不上
孔子教《三字经》	埋没人才
孔子面前讲《论语》	忘了自个儿姓名
抠到黄鳝，掉了笆笼（用竹篾编成的腹大口小的笼子）	因小失大
抠眼屎弄瞎了眼	因小失大
口吃报纸	咬文嚼字
口吃菠萝问酸甜	明知故问
口吃灯草	说得轻巧
口吃黄连	苦在心
口传家书	言而无信
口吹喇叭脚敲锣	能者多劳
口袋布做大衣	横竖不够料
口袋里倒西瓜	干净利索
口袋里买猫	好歹不分；不分好歹
口袋里冒烟	烧包
口袋里盛米汤	装糊涂
口袋里抓糍粑（ci ba）	粘上了；稳拿
口袋里装钉子	个个想露头
口袋里装王八	窝脖货
口袋里装绣针	露了锋芒
口袋里装锥子	锋芒毕露；藏不住
口含糍粑（ci ba）	难开腔
口含黄连脚踏苦胆	从头苦到脚；浑身苦
口含乱麻团	难嚼难咽
口含棉花	说得轻巧
口含盐巴拉家常	闲（咸）话多
口技表演	嘴上功夫
口嚼甘蔗渣	淡而无味
口嚼黄连唱山歌	苦中作乐
口渴吃酸梅	对口味
口渴的牛犊望井底	解不了渴
口渴喝盐汤	徒劳无益
口渴了才打井	来不及了
口渴碰到清泉水	正合适
口渴遇甘泉	正合心意
口里含蜜糖，肚里藏尖刀	嘴甜心毒
口水流到肚脐上	垂涎三尺
口水沾跳蚤	一物降一物
口吞秤砣	铁了心
口吞擀面杖	横了心
口吞萤火虫	心里亮
口吞账本	心中有数；肚里有数
口咽黄连	心里苦
口罩戴到鼻梁上	不要脸
叩头拜把子（朋友结为异姓兄弟）	称兄道弟
扣在笼子里的兔子	乱撞乱碰；挤挤撞撞
枯井打水	一无所获；劳而无功
枯井里打水	枉费工；徒劳无功；徒劳无益
枯木搭桥	存心害人
枯木刻象棋子儿	老兵老将
枯树根上浇水	白费功夫；白费劲
枯树烂木头	无用之树
枯树上的知了	自鸣得意
枯藤缠大树	生死不离
枯藤攀枫树	生死相依
哭孩子得了个洋娃娃	破涕为笑
哭了半天不知谁死了	自作多情
窟窿眼儿里看人	小瞧
苦胆煮黄连	苦汤熬苦药
苦豆子煮黄连	一个更比一个苦
苦瓜虫	吃内不吃外
苦瓜攀苦藤	苦相连
苦瓜树上结黄连	一个更比一个苦
苦瓜秧缠黄连树	苦相连；苦到一块了
苦瓜煮黄连	苦闷（焖）；苦在一起了
苦鬼遇饿鬼	难兄难弟；一模一样；没什么两样
苦海无边	回头是岸
苦水里面泡苦瓜	苦惯了（比喻已习惯子困苦的生活）
苦水里泡大的杏核儿	苦人（仁）儿
苦水里泡苦瓜	苦惯了
苦竹子根出苦笋	辈辈苦
裤裆放屁	串通一气（比喻狼狈为奸。）
裤兜里装五脏	窝囊废（肺）
裤腰带挂杆秤	自称自
裤腰带系在脖子上	错记
裤腰上挂死耗子	假充打猎人（比喻假充内行又不像。）
裤子里进蚂蚁	坐立不安
裤子套着裙子穿	不伦不类
夸嘴的郎中	无好药
挎着洋鼓捧着笙	自吹自擂
快刀砍骨头	干干脆脆；干脆
快刀砍黄鳝	一刀两断
快刀切豆腐	迎刃而解；干脆利索；两面光；两不沾
快刀切萝卜	干脆；干干脆脆
快刀切西瓜	一刀见红白；一分为二
快刀斩乱麻	干脆利索；一刀两断
快鼓配慢锣	不合拍
快锯伐大树	拉倒
快切豆腐不费劲	两面光；两不沾
快燃尽的蜡头	没多大亮
快燃尽的木炭	红火不了多时
快要倒塌的房子	危在旦夕
快嘴婆婆	有口无心
筷子戳粑粑	稳拿；甩不脱
筷子搭桥	难过；路子窄
筷子的一生	吃了就睡
筷子掉油篓	又奸（尖）又猾（滑）
筷子顶豆腐	树（竖）不起来
筷子夹骨头	全是光棍；光棍对光棍；三条光棍
筷子夹豌豆	不可多得；一个个来
筷子里拔旗杆	没高的
筷子配抵门扛	难成双；成不了对
筷子纫针（ren zhen引线穿过针鼻儿）	难过；通不过
筷子上抹油	光棍
筷子伸到茶壶里	胡（壶）搅
筷子挑凉粉	滑头对滑头
筷子跳舞	光棍一条
筷子挟骨头	三条光棍
筐里的烂瓜	数它坏
筐里选瓜	越选越差
筐中捉鳖	十拿九稳
筐子里堆乱麻	没有头绪
狂犬吠日	空汪汪
矿车过翻笼（翻车机。也称翻车器、翻罐笼）	倒个精光
葵花的盘子	老转向
葵花秆当柱子	不是正经材料；难撑难顶
葵花结子	心眼多
葵花籽里拌盐水	唁闲（捞咸）嗑
昆仑山上的灵芝草	无价之宝
捆绑的夫妻	过一天算一天；难成双；成不了对；长不了
困鸟出笼	展翅飞翔
垃圾倒进粪池里	同流合污
垃圾堆里安雷管	乱放炮
垃圾堆里的八骏图	废话（画）
垃圾堆里的东西	废物
垃圾堆里的破鞋	没人要的货；一钱不值
垃圾堆里的仕女图	废话（画）
垃圾堆里的蒜皮子	无用之物
垃圾堆里的乌拉（wu la东北地区冬天穿的鞋。用皮革制成，里面垫乌拉草）	没脸没皮
垃圾堆旁聊天	满口脏话
拉不出屎怨茅坑	错怪
拉车拉到路边边	使偏劲
拉大旗做虎皮	装面子
拉肚子吃补药	白搭；无济于事；白费劲
拉肚子吃泻药	胡摆治
拉二胡的练功	耍手腕
拉粪便嗑瓜子	进的少，出的多（比喻入不抵出。）
拉胡琴打喷嚏（pen ti）	弦外之音；弦外有音
拉胡子过河	谦虚（牵须）
拉开窗帘	开眼界
拉来黄牛当马骑	穷凑；穷凑合
拉痢吃辣椒	两头受罪
拉痢打摆子	躲了一灾又一灾；祸不单行
拉了弦的手榴弹	给谁谁不要
拉驴上市	冒充大牲口（比喻以小充大，以假充真。）
拉骆驼放羊	高的高，低的低
拉磨的驴戴眼罩	瞎转悠
拉牛入鼠洞	行不通；走不通
拉牛上树	办不到；没法办；难上加难
拉琴的丢唱本	没谱
拉琴的丢乐本	没谱儿了
拉石灰车遇到倾盆雨	心急如焚
拉屎薅（hao）草	一举两得
拉屎啃鸡腿	亏他张得开嘴
拉屎啃猪蹄	香香臭臭
拉屎拉到鞋跟儿里	提不得
拉屎攥（zuan握）拳头	暗里使劲；使暗劲
拉完磨子杀驴	恩将仇报；以怨报德
拉直狗腿	办不到；没法办
拉直牛角	白费功夫；枉费功；办不到；白费力气
拉着大粪车赶庙会	走到哪臭到哪；走一路臭一路
拉着耳朵擤（xinq）鼻涕	胡扯；劲用得不是地方
拉着何仙姑叫舅妈	五百年前是一家
拉着虎尾喊救命	自己找死（比喻自寻死路。）
拉着娄阿鼠叫干爹	认贼作父
拉着手走路	你行我也行
拉着土匪叫爹	认贼作父
拉着拖车卖豆腐	架子不小；好大的架子
拉着状元喊姐夫	想高攀
邋遢（la ta不利落；不整洁）兵败阵	连滚带爬；滚的滚，爬的爬
喇叭当烟囱	不对口径
喇叭断了线	不想（响）
喇叭佬娶老婆	自吹
喇叭嘴上塞泥巴	吹不响
腊八儿出生	动（冻）手动（冻）脚
腊皮人烤火	浑身都软了
腊皮鱼篓	滴水不漏
腊肉汤里煮挂面	有言（盐）在先
腊鸭子煮到锅里头	身子烂了，踊头还硬（比喻身子受了苦，嘴上还是不肯说。）
腊鸭子煮锅里	身子烂了嘴还硬
腊月的井水	热乎乎
腊月底看农历	没日子啦
腊月二十三的灶王爷	离板了
腊月里吃黄连	寒苦
腊月里的梅花	傲霜斗雪
腊月里借扇子	火气太大；冷不防
腊月里扇扇子	火气太大（比喻脾气十分暴躁。）
腊月里送蒲扇	不识时务
腊月里遇上狼	冷不防（比喻意料外的。）
腊月里遇着狼	冷不防
腊月卖凉粉	不是时候
腊月盼打雷	空想；不识时务
腊月三十贴对子	一年一回
腊月三十洗长衫	今年不干明（来）年干
腊月天找杨梅	难得；得之不易
腊月贴门神	一个向东，一个向西
腊月尾正月头	不愁吃
腊月种小麦	外行
瘌痢头害脚癣	两头不落一头
瘌痢头上的虱子	无地容身；无处藏身
蜡人玩火	自顾不暇
蜡台上无油	空费芯（心）
蜡制的苹果	好看不好吃
蜡烛的脾气	不点不明
蜡烛的一生	照亮别人，毁了自己
蜡烛点火	一条心
辣椒炒豆腐	外辣里软（比喻人外表强硬而内心怯懦。）
辣椒粉吹进鼻眼里	够戗（够受的）
辣椒棵上结茄子	经得发紫
辣椒面捏关爷	红人
辣蜊蜊（la la qu）蝼蛄穿大褂	硬充土绅士
辣子（辣椒）拌老姜	辣对辣
癞大哥坐秤盘	自称自大
癞格宝（癞蛤蟆）变的	专吃自来食
癞格宝上墙	巴不得（迫切盼望）
癞蛤蟆剥了皮	死不瞑目；心不死；不死心
癞蛤蟆剥皮不闭眼	还想蹦达几下（比喻还想作垂死挣扎。）
癞蛤蟆不长毛	天生这种路；没法治
癞蛤蟆吃秫秫（高梁）	顺杆（秆）爬
癞蛤蟆吃天	无从下口；难下口
癞蛤蟆吃骰子	一肚子点子
癞蛤蟆吃樱桃	想头不低；想得高
癞蛤蟆穿大红袍	只可远看，不能近瞧（比喻仔细一瞧就露馅了。）
癞蛤蟆吹唢呐	没人声；难听；小气
癞蛤蟆打吹欠	好大的口气
癞蛤蟆打伞	怪事一桩；怪事
癞蛤蟆带娃娃	只讲个数
癞蛤蟆戴花	臭美
癞蛤蟆戴笼头	怪相；你算什么畜牲
癞蛤蟆的脊梁	点子多
癞蛤蟆垫床脚	死撑活挨
癞蛤蟆跌粥锅	说他混蛋，他还一肚子气
癞蛤蟆躲端午	躲过初一，躲不过十五
癞蛤蟆赶船	搭不上帮
癞蛤蟆过壕沟	干瞪眼；白瞪眼
癞蛤蟆过江	自身难保
癞蛤蟆挎大刀	邋遢（ld ta不利落;不整洁）兵
癞蛤蟆爬香炉	触一鼻子灰
癞蛤蟆敲大鼓	自吹自擂
癞蛤蟆请客	四眼相顾
癞蛤蟆上餐桌	倒霉透了；扫兴
癞蛤蟆上樱桃树	光想高味
癞蛤蟆生蝎子	一窝更比一窝毒（比喻一代比一代阴险、歹毒）
癞蛤蟆栓在鳖脚上	跳不高，爬不快
癞蛤蟆跳到秤盘上	自称自（比喻自己称赞自己）
癞蛤蟆跳到热鏊（ao烙饼的炊具。铁制圆形平底）上	蹦不了几下；自己找死
癞蛤蟆跳戥（deng叩戥子。测定贵重物品或药品重量的小秤）盘	不知自己有多少斤两
癞蛤蟆跳井	不懂（扑通）
癞蛤蟆跳上金銮殿	登峰造极
癞蛤蟆跳油锅	寻死；自己找死
癞蛤蟆吞蒺藜（ji li一年生草本植物。果皮有尖刺）	干吃哑巴亏；吃了哑巴亏
癞蛤蟆吞鱼钩	自作自受
癞蛤蟆吞月亮	痴心妄想
癞蛤蟆遭牛踩	末日来临
癞蛤蟆张口	专吃自来食
癞蛤蟆追兔子	一步跟不上，步步跟不上；一步赶不上，步步都紧张
癞蛤蟆坐飞机	一步登天
癞蛤蟆坐金銮殿	痴心妄想
癞和尚念经	走样了
癞痢头撑伞	无法（发）无天
癞痢头上长肿瘤	突（秃）出
癞痢头上的伤疤	明摆着
癞蟆的脊梁	点子多；点子不少
癞皮狗上轿	招摇撞骗
癞头婆生疮	丑上加丑
癞头婆死老公（丈夫）	无法（发）无天
癞子长脚板疮	上下都有毛病
癞子吃猪肉	块块好
癞子当和尚	不费手续
癞子的脑袋	不好提（剃）（比喻不好谈。或很难对付。）
癞子的脑壳	没法（发）
癞子剃头	看货
癞子头上抓痒	求之不得
栏杆上摆花盆	无地自容
栏里关的猪	蠢货
蓝球场上的裁判	跟着跑
蓝天上的白云	自由自在
蓝天上的气球	轻飘飘的
蓝天上的云彩	随风飘
篮子里挑花	越看眼越花
篮子里装土地菩萨	提神
懒厨子办席	不想吵（炒）
懒厨子做席	不想给你吵（炒）
懒大嫂赶场	中间不急两头忙
懒姑娘头上的虮子（ji zi虱子的卵）	一串一串的
懒汉不拉纤	顺水推舟
懒鸡婆抱窝	守着摊儿过
懒驴进磨道	自上圈套
懒驴上磨	屎尿多
懒驴子驾辕	不打不走
懒驴子上套	打一鞭走一步
懒木匠的锯子	不错（挫）
懒鸟不搭窝	得过且过
懒牛拉磨	不打不走；上了圈套
懒牛懒马干活	屎尿多
懒牛上套	屎尿多
懒婆娘穿袜头	老一套
懒婆娘的包袱	窝窝囊囊
懒婆娘的裹脚布	又臭又长
懒婆娘的剪刀	难开口；不好开口
懒婆娘的针线筐	乱七八糟
懒婆娘干活	慢慢磨
懒婆娘上鸡窝	笨（奔）蛋
懒婆娘坐轿	愿上不愿下
懒人的铺盖	不理
烂板桥上的龙王	不是好东西
烂板子搭桥	难过；不顶事
烂鼻子菩萨	闻不着香臭
烂鼻子闻猪头	不知香臭
烂边礼帽	顶好
烂粪箕捞泥鳅	溜啦
烂膏药贴在好肉上	没病找病；自找麻烦
烂瓜皮当帽子	霉到顶了
烂筐子上拴丝穗子	不相称
烂了的番茄满街送	不识时务
烂了根的葱	心不死
烂麻搓成绳	吃不住劲
烂麻袋装珍珠	好的在里面
烂麻里搀猪毛	一团糟
烂麻拧成绳	有了头绪；合在一起干
烂木头刻章	不是这块料
烂木头	做不得大梁
烂木头做梁柱	难顶难撑
烂脑瓜戴上新毡帽	冒充好人
烂泥巴糊墙	外光里不光；表面光；上不去
烂泥巴捏神像	没个好心肠；全靠贴金
烂泥巴下窑	不成东西；难成器
烂泥补柱子	难顶难撑
烂泥里摇桩	越陷越深
烂泥路上开汽车	卷土重来
烂泥路上拉车	越陷越深
烂泥坯子贴金身	胎里坏；坏了胎
烂泥菩萨	样子神气
烂泥菩萨洗脸	干净不了
烂泥下窑	烧不成个东西（比喻能力差或本质不好的人办不成事；）
烂屁股蜘蛛	没事（丝）
烂菩萨坐深山	没人理；没见过大香火
烂蒲扇打人	无关痛痒；不痛不痒
烂汽车过朽桥	乘人之危
烂肉喂苍蝇	投其所好
烂伞遮日	半边阴
烂扫帚上市	分文不值
烂柿子换核桃	吃硬不吃软
烂柿子落地	软瘫了
烂柿子上船	软货
烂田里的活路	难做
烂田里的石臼	永世不得翻身
烂田里翻碌碡（liu zhou 石磙）	越陷越深
烂透的毒疮	不可救药
烂袜子改背心	小人得志（之）
烂网打鱼	一无所获
烂乌拉（wu la东北地区冬天穿的鞋。用皮革制成，里成垫乌拉草）套没底袜	差对差；差配差
烂西瓜	一肚子坏水
烂眼招苍蝇	倒霉透了；真倒霉
烂鱼开了膛	一副坏心肠；心肠坏
烂钟	没准儿
烂猪头碰到烂肠子	臭味相投
烂柱子搭桥	不牢靠
郎中（中医医生）卖棺材	死活都要钱
郎中咬牙	恨人不死
狼吃东郭先生	恩将仇报；以怨报德
狼吃蓑衣	没有人味
狼叼来的喂狗	白享受
狼给羊献礼	没安好心
狼哭羊羔	假仁假义；虚情假意；假慈悲
狼夸羊肥	不怀好意
狼头上插竹笋	装样（羊）
狼头上戴斗笠	假充好人
狼窝里的肉	难久留
狼窝里的羊	九死一生
狼窝里养孩子	性命难保
狼也跑了，羊也保了	两全其美
狼崽进羊圈	没好事；不是好事
狼装羊笑	没安好心；居心不良
浪里撑船	看风使舵
浪头撞在礁石上	粉身碎骨
浪中行船	时高时低
浪子回头	金不换；弃恶从善
捞到虾公还要鲤鱼	好了还要更好
劳动号子	一呼百应
劳摸作报告	传经送宝
牢房里赌博	一错再错
痨病鬼儿开药店	自己图方便
老白干儿（白酒）泡砒霜（pi shu6ng砷的氧化物。剧毒）	又毒又辣；毒辣
老包（包公）断案	认理不认亲
老保姆带孩子	人家的
老鳖跌跟头	翻了
老鳖吞秤砣	狠心王八
老鳖咬人	叼住不放；死不丢
老刺猬下山	一骨碌
老大哥拍胸脯	兄弟放心
老大懒惰老二勤	一不做，二不休
老大爷干活	不利索
老大坐车，老二骑马	各走各的路
老旦唱小生	不像样
老雕变成夜猫子	越变越糟；一辈不如一辈
老雕戴帽子	冒充鹰
老掉牙的虎	雄心在
老掉牙的驴	顾（雇）不得
老坟头里的尸骨	空架子
老坟头里上拉屎	糟踏祖先
老佛爷念素珠	心中有数；肚里有数
老公（丈夫）打扇	凄（妻）凉
老公公吹笛子	气力不足
老公鸡披蓑衣	嘴尖毛长
老公鸡着火	官僚（冠燎）
老姑娘拜天地	去了心事
老鸹（lao qua 乌鸦）叮蚌壳	难脱身；脱不了身
老鸹喝墨水	从外黑到心
老鸹落在煤堆上	不显眼；显不着你
老鸹落在猪身上	光看别人黑，不见自己黑
老鸹配凤凰	痴心妄想；妄想
老鸹站树梢	呱呱叫
老鸹爪子	黑手
老鸹钻出烟囱	从黑道上来的
老寡妇嫁到饭馆里	讲吃不讲穿
老寡妇遇见老绝户	孤的孤，苦的苦
老海瑞上金殿	为民请命
老汉的枕头	一包草
老汉啃甘蔗	咬牙切齿
老和尚搬家	吹灯拔蜡
老和尚的百衲衣	东拼西凑
老和尚讲佛经	说的说，听的听
老和尚念经	句句真言；千篇一律；照本宣科
老和尚诵经	念念有词
老和尚剃头	一扫光
老和尚撞钟	得过且过；过一天算一天
老葫芦爬秧	越拉越长
老虎扮和尚	人面兽心
老虎背上翻跟头	找死；自取其祸；惹祸上身
老虎背上拍苍蝇	送死；自己找死
老虎背上玩把戏	胆大心细
老虎背十字架	冒充耶稣
老虎变猪猡	又丑又恶；又笨又恶
老虎不吃人	恶名在外；名声不好
老虎吃鼻烟	胡吹一气；真能吹
老虎吃刺猬	无法下口
老虎吃豆芽	小菜一碟
老虎吃蚂蚁	不够塞牙缝，不够嚼
老虎吃蚂蚱	小菜一碟；不过瘾；小菜儿；不够塞牙缝
老虎吃牛	大干一场
老虎吃蜻蜓	不过瘾
老虎吃算盘珠	心中有数；肚里有数
老虎吃天	难下爪；不知高低
老虎吃田螺	无从下口；难下口；无法下口
老虎吃跳蚤	供不应求
老虎吃兔子	一口吞；囫囵（hu lun完整；整个儿）吞
老虎吃羊羔	不吐骨头
老虎出山	浑身是胆；横冲直撞
老虎出山遇见豹	一个更比一个凶；一个更比一个恶
老虎打摆子	窝里战（颤）
老虎打架	劝不得
老虎打瞌睡	机会难得；难得的机会
老虎逮耗子	有劲使不上；耍的什么威风
老虎戴佛珠	假慈悲；假慈善
老虎戴脚镣	欲凶无力
老虎当马骑	有胆有魄
老虎的胡子	摸不得；拔不得
老虎的屁股	拍不得；摸不得
老虎的头发	没人理
老虎洞里砌神台	莫名其妙（庙）
老虎赶猪	冒充善人
老虎驾辕	没人敢（赶）；谁敢（赶）
老虎借猪狗借骨	有借无还
老虎借猪	有去无回
老虎金钱豹	各走各的路；各行各的道
老虎近身	开口是祸
老虎进棺材	吓死人
老虎进庙堂	没安好心
老虎拉车	没人敢（赶）；不听那一套
老虎离山落平原	抖不起威风
老虎咧嘴笑	阴险歹毒
老虎落陷阱	有劲使不上；命难逃
老虎没了皮	威风扫地
老虎念经	假正经；口是心非
老虎披蓑衣	没个人模样
老虎屁股	摸不得
老虎屁股上抓痒痒	自取其祸；惹祸上身
老虎上磅秤	自称威风
老虎上吊	没人敢救
老虎烧香	冒充善人
老虎身上的虱子	没人敢惹；惹不起
老虎添翼	好威风
老虎舔糨糊	不够煳（糊）嘴
老虎舔胸脯	吃人心肝
老虎头皮蛇尾巴	有始无终
老虎头上的苍蝇	拍不得
老虎头上拉屎	好大的胆子；好大胆
老虎头上撒胡椒	大胆泼辣
老虎头上捉虱子	不怕死；好心不得好报
老虎推磨	不听那一套
老虎吞石狮	吃不消
老虎拖象	大干一场
老虎尾巴绑扫帚	威风扫地
老虎演戏	难收场；看不得；下不了台；收不了场
老虎爪子蝎子心	又狠又毒
老虎追得猫上树	多亏留了一手
老虎嘴里拔牙	找死；送死；寻死
老虎嘴里讨脆骨	不是好惹的
老虎嘴里讨食	胆子不小；胆子大；好大胆
老虎嘴上拔胡子	找死；送死；自己找死；胆子不小；胆子大
老虎坐庙堂	想充神仙
老槐树枯了心	外强中干
老将出马	一个顶俩
老将耍镰刀	少见（剑）
老九的弟弟	老实（十）
老舅舅拉破二胡	陈词滥调
老君爷（道教对老子的尊称）叫蛇咬	无法可使
老寇准背靴子	明察暗访
老来得子	大喜
老来学绣花	心灵手不巧
老两口吵架	公说公有理；婆说婆有理
老两口观灯	走着瞧
老两口埋在一个坟里	死活一对
老两口赏月	平分秋色
老两口演戏	夫唱妇随
老猎手打野兽	百发百中
老柳树发新芽	回春
老龙王搬家	厉害（离海）
老龙王投江	死得其所
老驴噙本《三字经》	咬文嚼字
老虑戴上假面具	人面兽心
老妈妈补衣裳	见缝插针
老妈妈奶孩子	舍己为人；枉费心
老妈子带孩子	人家的
老妈子侍侯人	拿手戏
老猫犯罪狗戴枷	无辜受罪；嫁祸于人
老猫拿（捉）耗子	一物降一物
老猫上锅台	熟路；道熟
老猫上树	紧抓挠
老猫偷食狗挨打	错怪
老猫卧房脊	一辈传一辈
老面蒸馒头	发得快
老母鸡斗黄鼠狼	不是对手
老母鸡生疮	毛病
老母鸡跳进药材铺	自找苦吃
老母鸡下蛋	脸红脖子粗；呱呱叫
老母牛上场	屎尿多
老母猪摆擂台	丑八怪逞能
老母猪剥皮	露骨
老母猪吃芥末（调味品。味辣）	脸上贴金
老母猪吃醪糟	酒足饭饱
老母猪吃破鞋	心里有底
老母猪打架	全凭一张嘴；全仗嘴
老母猪打喷嚏（pen ti）	笨嘴拙舌
老母猪戴金耳环	冒富
老母猪的耳朵	软骨头
老母猪的尾巴	拖泥带水
老母猪拱地	好硬的嘴
老母猪逛花园	眼花缭乱
老母猪和牛打架	豁出老脸来了
老母猪进夹道	进退两难
老母猪进粮仓	贪吃贪喝；饱吃饱喝
老母猪啃槽	耷拉（da la下垂）着脑袋；不抬头
老母猪啃瓷砖	满嘴词（瓷）
老母猪啃猪圈	嘴巴痒了
老母猪啃砖头	好硬的嘴
老母猪尿窝	自作自受
老母猪敲门	哪里来的蠢货
老母猪下棋	瞧你那笨脑瓜
老母猪嫌米糠	反常
老母猪追兔子	上气不接下气
老母猪钻篱笆	进退两难
老木匠的家什	要啥有啥
老木中空	外强中干
老奶奶吃软柿子	正好
老奶奶的发髻	输（梳）定了
老奶奶的嫁衣	老古董
老尼姑瞧嫁妆	没指望
老牛挨鞭子	忍辱负重
老牛闯进瓷器店	破的破；烂的烂
老牛吃草	吞吞吐吐
老牛出工	让人牵着鼻子走；浑身是劲
老牛打滚	大翻身
老牛打喷嚏（pen ti）	笨嘴笨舌
老牛大憋气	不吭声
老牛掉进深泥潭	不能自拔
老牛反刍	吞吞吐吐
老牛赶山	走到哪天算哪天
老牛喝水	不抬头
老牛啃地皮	耷拉（da la下垂）着脑袋
老牛啃瓜	不抬头
老牛拉犁马拉车	浑身是劲
老牛拉磨	团团转；慢工出细活；默默无闻
老牛拉碾	原地打转
老牛拉破车	两凑合；慢腾腾；松松垮垮
老牛拉稀屎	接连不断
老牛拉座钟	又稳又准
老牛撵（nian追赶）兔子	有劲使不上
老牛身上拔根毛	微不足道
老牛拴在树桩上	没跑；跑不了
老牛踏垡子（fa zi翻耕过的土地）	一步一个脚印
老牛头进汤锅	难熬
老牛脱了磨	空转一遭
老牛追骏马	撵（nian追赶）不上；老落后；落后了
老牛追汽车	赶不上；撵不上
老牛走老路	照旧
老牛钻狗洞	难通过；通不过
老牛钻耗子洞	行不通；走不通
老牛钻鸡窝	没门
老牌子钢针	宁折不弯
老婆婆抱孙子	喜笑颜开
老婆婆吃腊肉	扯皮
老婆婆戴刺梨花	人家不夸自己夸
老婆婆当兵	充数儿
老婆婆荡秋千	玩命
老婆婆的破包袱	窝囊一辈子
老婆婆翻跟头	一蹶不振
老婆婆纺线	拖拖拉拉
老婆婆喝稀饭	无耻（齿）下流
老婆婆看嫁妆	下一辈子的事
老婆婆赛跑	精神可嘉
老婆婆烧香	一片诚心；心诚
老婆婆跳皮筋	非同儿戏
老婆子当兵	充数
老婆子落水	凄（妻）凉
老人家拜年	一年不如一年
老山猫呲牙	笑面虎
老艄公撑船	看风使舵
老寿星的脑袋	宝贝疙瘩
老寿星的座椅	四不像
老寿星还童	面目全非
老寿星骑仙鹤	没路（鹿）
老寿星上吊	活得不耐烦了；活够了
老鼠挨一百棒	面不改色
老鼠吃高粱	顺杆（秆）爬
老鼠吃海水	无足轻重
老鼠吃猫	怪事
老鼠打架	小抓挠
老鼠盗葫芦	大头在后面；大的在后头
老鼠掉进面缸里	翻白眼
老鼠跌进米囤里	因祸得福
老鼠跌进铁桶里	无缝可钻
老鼠跌坛子	有进无出
老鼠跌香炉	触一鼻子灰
老鼠给大象指路	越走越窄
老鼠给猫捋（iv 用手指顺着抹过去；使物体顺溜或干净）胡子	送死；自己找死
老鼠给猫祝寿	自送一口肉；送来的口食
老鼠跟猫睡觉	练胆子
老鼠攻墙	家贼难防
老鼠过街	人人喊打
老鼠嫁花猫	冤家变亲家
老鼠见了猫	吓破了胆
老鼠进洞	拐弯抹角
老鼠进棺材	咬死人
老鼠进口袋	寻死；自己找死
老鼠看仓	越看越光
老鼠看天	小见识
老鼠扛大枪	窝里逞能
老鼠啃大象	难下口；无法下口
老鼠啃擀面杖	白费牙
老鼠啃鸡蛋	无从下口
老鼠啃菩萨	没有人味；没人味
老鼠拉秤砣	自塞门路
老鼠拉骆驼	野心太大；野心勃勃
老鼠拉木掀	大头在后面
老鼠拉王八	找不到头・
老鼠落在砻糠（long kang稻谷砻过后脱下的外壳）里	白欢喜；空喜一场
老鼠闹洞房	唧唧喳喳
老鼠跑进食盒里	抓住理（礼）了
老鼠碰上猫	在劫难逃
老鼠骑水牛	大的没有小的能；小能降大
老鼠娶妻遇老猫	又喜又悲；悲喜交加
老鼠上了老鼠夹	死到临头；死在眼前
老鼠抬轿子	担当不起
老鼠舔猫鼻	找死；送死；自己找死
老鼠跳到糠箩里	空欢喜
老鼠跳火坑	毛干爪净
老鼠偷秤砣	倒贴（盗铁）
老鼠偷拖西瓜	连滚带爬；滚的滚，爬的爬
老鼠偷芝麻	吃香
老鼠尾巴熬汤	没多大油水
老鼠尾巴	大不了
老鼠尾巴害疖子	脓水不大
老鼠尾巴上绑鸡毛	不是好鸟；不是正经鸟
老鼠尾巴生疮	小毛病
老鼠咬铳（chong一种旧式火器）	两败俱伤
老鼠咬猫	要拼命；拼啦；天下奇闻；无奇不有
老鼠咬牛	大干一场
老鼠咬旗杆	吃不到（倒）
老鼠咬石柱	攻不倒
老鼠咬乌龟	无从下口；难下口；无法下口
老鼠咬象鼻	不识大体
老鼠咬灶君	欺神灭相
老鼠钻风箱	两头受气
老鼠钻进火筒	两头受气（比喻受到两边或两方面不就有的埋怨和责备。）
老鼠钻烟囱	够戗（够受的）
老鼠嘴里讨碎骨	莫想
老鼠做寿	小打小闹
老水牛拉马车	不合套
老太婆搽胭脂	不知自丑
老太婆吃黄连	苦口婆心
老太婆吃猪蹄	横扯筋；扯筋
老太婆垫铺衬（碎布头或破布）	一层管一层
老太婆改嫁	事出有因
老太婆过年	一年不如一年；过一年少一年
老太婆啃窝头	细嚼慢咽
老太婆纳鞋底	千真（针）万真（针）
老太婆上台阶	步步高升；步步登高
老太婆数鸡蛋	一个个来
老太婆住在高楼	上下两难；上下为难
老太婆坐牛车	稳稳当当
老太太补衣服	东拼西凑
老太太吃炒胡豆	咬牙切齿
老太太吃海蜇	搬嘴弄舌
老太太吃年糕	闷了口
老太太吃牛筋	食而不知其味
老太太吃柿子	专拣软的捏
老太太吃汤圆	囫囵（hu lan完整；整个儿）吞
老太太打补丁	东拼西凑；穷凑合
老太太打哈欠	一望无涯（牙）
老太太得孙子	大喜
老太太的脚趾头	委屈一辈子
老太太的金莲（旧时指缠足妇女的脚）	窝囊一辈子；委屈一辈子
老太太的鞋	前紧后松
老太太的嘴	吹软不吃硬；说不完的话
老太太纺纱	越扯越长
老太太过溜冰场	走险
老太太开了话匣子	唠唠叨叨
老太太啃骨头	软磨硬顶
老太太啃鸡脚	难嚼难咽；横扯筋
老太太哭儿	没指望
老太太扭秧歌	笨手笨脚
老太太上台阶	一步步来
老太太算账	一码是一码
老太太洗萝卜	一个一个来
老太太学钢琴	手忙脚乱
老太太学绣花	心灵手笨
老太太走独木桥	难过
老太太走路	慢腾腾
老太太坐飞机	抖起来了；一步登天
老套子卷珍珠	内中有宝
老藤爬树	缠住不放
老天爷不下雨，当家的不说理	奈何不得；无可奈何
老天爷拄拐杖	一竿子插到底
老头吃麻糖	越拉越长；越扯越长
老头儿发脾气	吹胡子瞪眼
老头牵瘦驴	顾（雇）不得
老头子联欢	非同儿戏
老头子坐摇篮	装孙子
老王卖瓜	自卖自夸
老相识见面鞠一躬	有礼
老熊奔陷阱，野猫钻圈圈	一物降一物
老熊爬杆	上不去
老鸦背上插花翎	自以为美
老鸦唱山歌	不入调
老鸭公唱戏	喉咙不争气
老鸭公想唱戏	喉咙不争气
老洋芋充天麻	公开作假
老爷家里当差的	低三下四
老爷庙求子	走错了门
老爷坐马桶	赃（脏）官
老鹰变成夜猫子	一代不如一代；一辈不如一辈
老鹰捕食	见机（鸡）行事
老鹰得肠	欢喜若狂
老鹰叼黄牛	贪欲太大
老鹰叼蛇	十拿九稳
老鹰抓蓑衣	脱不了爪
老鹰抓小鸡	轻拿；捧上天了；居高临下；一提就走；有去无回
老鹰追兔子	一个天上，一个地下
老鹰啄田埂	白磨嘴皮子
老榆木疙瘩	挪不动
老玉米里搀白面	粗中有细
老张的拳头捣老张的腿	自作自受
老蜘蛛的内脏	满肚子私（丝）；一肚子私（丝）
老子哭儿	惨不忍睹
老子纳妾儿嫖娼	一窝不正经
老子纳妾儿姘居	上梁不正下梁歪
老子入团儿入党	一代更比一代强
老子偷蛋儿偷鸡	一辈更比一辈坏
老子偷瓜儿盗果，老子杀人儿放火	辈更比一辈坏
老子偷猪儿偷牛	一辈更比一辈坏
老子坐班房，儿子挨夹杠	受人牵连
乐队里的锣鼓	任人敲打
乐队里敲破锣	不入调
乐山的大佛	老实（石）人
勒紧裤带过日子	日子难过；岁月难熬
勒紧裤带拉二胡	穷作乐；穷快活
雷公打豆腐	拣软的欺；不堪一击
雷公打芝麻	专拣小的欺
雷公动怒	不同凡响；惊天动地
雷公躲进土地庙	天知地知
雷公劈城隍	以上压下
雷公劈海椒（辣椒）	火辣辣的脾气
雷公劈蚂蚁	大的欺负小的
雷婆找龙王谈心	天涯海角觅知音
雷声大，雨点小	有名无实
雷雨天下冰雹	一落千丈
垒鼓配银锣	配得起你
肋条换猪爪	不上算；不合算
擂鼓奏唢呐	吹吹打打；又吹又打
冷饭团发芽	无奇不有；天下奇闻
冷锅爆豆子	不声不响；无声无息
冷锅贴饼子	溜啦
冷镬子（huo zi锅）里爆出热栗子	不可能的事；没人见过；没有的事
冷水浇头	凉了半截
冷水沏茶	等着吧；慢慢来；无味
冷水齐腰	凉了半截
冷水梳头	一时光
冷水烫鸡	一毛不拔
冷天戴手套	保守（手）
冷天吞了热汤圆	身上暖烘烘，心上甜滋滋
冷眼观螃蟹	看你横行到几时
狸猫换太子	以假充真
离了水晶宫的龙	寸步难行
离群的羊羔	孤孤单单
离水的鱼儿	难活命；性命难保
离枝的鲜花	活不久；活不长
犁地的甩鞭	吹（催）牛
犁地淹死牛	伤（墒）透了
黎明的觉，半道的妻，羊肉饺子清炖鸡	难得的好处
李逵扮新娘	装不像
李逵穿针	粗中有细
李逵断案	强者有理
李逵开铁匠铺	人强货硬
李逵抡板斧	以势压人
李逵骂宋江，过后赔不是	负荆请罪
李逵卖煤炭	黑对黑；黑上加黑
李逵绣花	力不能及；力不从心
李时珍看病	手到病除；妙手回春
李世民登基	顺应民心
李世民捏窝窝头	御驾亲征（蒸）
里插竹竿	横生枝节；横行霸道
理发店关门	没头了；不理了
理发店收徒弟	从头来；从头学起
理发匠登金榜	行行出状元
理发师教徒弟	从头来；从头学起
理发师上鞋（把鞋帮、鞋底缝在一起）底	从头包到脚
理字卖给阎王爷	不讲道理
鲤鱼产卵	一撒一大片
鲤鱼吃秤砣	铁了心
鲤鱼吃水	吞吞吐吐
鲤鱼戴斗笠	愚（鱼）人
鲤鱼的本领	专往软处钻
鲤鱼的胡子	没几根
鲤鱼护窝	不会走多远
鲤鱼落在灰堆里	越弄越湖涂
鲤鱼碰网	白取灭亡
鲤鱼剖腹	开心
鲤鱼跳船上	不劳（捞）而获
鲤鱼跳到鱼船上	寻着死来
鲤鱼跳龙门	身价百倍；高升了
鲤鱼下油锅	死不瞑目
鲤鱼咬钓钩	吞不下，吐不出
鲤鱼找鲤鱼，鲫鱼找鲫鱼	物以类聚
立春响雷	一鸣惊人
立秋的石榴	点子多
利剑斩乱麻	一刀两断
荔枝皮翻个儿	点子多；点子不少
俩狗打架	你咬我，我咬你；以牙还牙
俩和尚打架	谁也抓不到谁的辫子
俩牛抵角	豁着脑袋干
俩牛相斗	顶顶撞撞；又顶又撞
俩螃蟹打架	纠缠不清
俩兽医抬一头驴	没法治；没治了
俩哑巴见面	没说的
俩哑巴睡一头	好得没法说；无话可说
俩哑巴说话	比比划划
连鬓胡子吃麻糖	纠缠不清
莲梗打人	思（丝）情不断
莲梗结籽	心连心
莲花并蒂开	恰好一对
莲藕炒粉条	无孔不入
莲藕吹风	似通非通；半通不通
莲藕生疮	坏心眼
莲藕有节又有孔	似通非通
廉颇背荆条	负荆请罪
镰刀对斧头	硬碰硬
镰刀卡在喉咙里	吞不下，吐不出
脸蛋上的痤疮	疙疙瘩瘩
脸蛋贴膏药	眼前就是毛病；破相
脸盆里的泥鳅	看你滑到哪里去
脸盆里摸鱼	十拿九稳
脸盆里扎猛子	不知深浅
脸上含笑，脚下使绊子	暗伤人；暗中伤人
脸上贴膏药	面子上不好看；破相
脸上贴狗毛	不知好歹；好歹不分
脸上写字	表面文章
练兵场上的耙子	众矢之的
练武术的不拿刀枪	赤手空拳
凉水泡豌豆	冷处理
梁山伯看到祝英台	一见钟情
梁山伯与祝英台	生死相依；生死不离
梁山泊的军师	无（吴）用
梁山泊的王伦	容不得人；不能容人；谁都容不得
梁山泊的吴用	足智多谋
梁山泊的兄弟	不打不相识；志同道合
梁上吊死人	上不着天，下不着地
梁头上吊王八	四脚无靠
梁柱上插针	粗中有细
粮库里头一颗谷	有你不多，无你不少
两把号吹成一个调	想（响）到一块了
两代寡妇	没功（公）夫
两分钱的醋	又酸又贱
两分钱的韭菜	一小撮
两分钱开店铺	周转不开；穷张罗
两分钱买个羊蹄子	横扯筋；扯筋
两分钱买一篮子菜	不是好货；不是好东西
两分钱一个猪	脸面不值钱
两副重担一肩挑	难上难；难上加难
两个巴掌打人	左右开弓
两个鼻子眼出气	息息相关
两个槌敲一面锣	想（响）到一块了
两个第一	不相上下
两个肩膀找张嘴	走到哪里吃到哪里
两个叫花子（乞丐）拜堂	穷配穷；穷凑合
两个喇叭一个调	想（响）到一块了
两个泥菩萨过河	谁也救不了谁
两个琵琶一个调	谈（弹）到一块儿去了
两个人打排球	推来推去；互相推脱（托）
两个人奏笙	一个吹，一个捧；你吹我捧
两个山字重起来	请出
两个秀才当文书	字字推敲
两个哑巴吵架	不知谁是谁非；难断是非
两个羊羔打架	对头
两个月的囡（nan 小孩儿）	逃不了
两个醉汉睡觉	东倒西歪
两股道上的车	撞不上；各走各的路；各行各的道
两股脏水汇一起	同流合污
两横加一竖	干
两虎相斗	必有一伤；自相残杀
两架破飞机	对不起
两口子拜年	多此一举
两口子拜堂	欢天喜地
两口子唱《西厢记》	真真假假
两口子唱戏	一唱一和；夫唱妇随
两口子锄地	不顾（雇）别人
两口子打官司	一言难尽
两口子的帐	难算；算不清；说不清
两口子对着吹喇叭	斗气
两口子分家	各人顾各人
两口子赶集	志同道合
两口子回门	成双成对
两口子推磨	齐心协力
两勤夹一懒	一不做，二不休
两人盖床小被子	顾了这头丢那头
两扇磨磨面粉	缺一不可
两手架鼓	等着挨敲
两手抹糨子（jian zi糨糊）	粘土了
两手托刺猬	棘手；碰到棘手的
两手攥（zuan握）三大钱	一是一，二是二
两条道上跑的车	各不相干
两条腿的板凳	坐不稳；站不住脚
两响炮升天	想（响）到一块了
两眼一眨，老母鸡变鸭	说变就变；转眼就变；变化无常
两样布夹袄	表里不一
两张纸画个驴头	好大的脸皮
两只耳朵	生死不见面
两只风筝一块飞	胡搅蛮缠
两只手写对联	双管齐下
两只眼盯着一个小钱	见钱眼开
亮月下耍大刀	胡砍
晾衣竿钩月亮	差天远
聊斋上的文章	鬼话连篇
鹩哥（liao ge鹪鹩。小鸟）落在牛背上	无足轻重
林冲到了野猪林	绝处逢生
林冲看守草料场	英雄无用武之地
林冲上梁山	逼出来的；官逼民反
林冲误闯白虎堂	上当受骗
林子里的斑鸠	一对儿
临嫁的姑娘	满面春风；春风满面
临拉屎挖茅坑	手忙脚乱
临老当和尚	半路出家
临老得了摇头病	身不由己；不由自主
临老学绣花	晚了；迟了
临上轿才缠脚	临时忙
临上轿穿耳朵	来不及
临死挨了一巴掌	死不要脸
临刑不告饶	执迷不悟
临刑唱大曲	视死如归
临阵磨枪	迟了
淋了雨的熟石榴	咧开了嘴
吝啬鬼走亲戚	两手空
灵堂上唱大戏	又哭又笑；哭的哭；笑的笑’
岭上唱山歌	高调
岭头上对歌	唱高调
铃铛掉了舌头	不想（响）；没想（响）头了
铃铛敲锣鼓	想（响）在一起了
菱角碰粽子	尖对棱；奸（尖）对奸（尖）
另搭台子唱戏	从头来
另起炉灶	各顾各
刘阿斗的江山	白送
刘备的江山	哭出来的
刘备对孔明	言听计从
刘备借荆州	有借无还
刘备卖草鞋	本行
刘备三顾茅庐	尽找明白人
刘备三请诸葛亮	诚心诚意
刘备上了黄鹤楼	胆战心惊；战战兢兢
刘备摔阿斗	收买人心
刘备遇孔明	如鱼得水
刘禅乐不思蜀	忘本
刘胡兰钻铡刀	宁死不屈
刘姥姥进大观园	满载而归；着花了跟；洋相百出；眼花缭乱
刘姥姥坐席	出洋相；洋相百出
流浪汉坐远洋轮	四海为家
流水簿做袍子	浑身是债；满身都是帐
流水滩头	有余（鱼）
留得青山在	不怕没柴烧
琉璃瓶上安蜡扦	又奸（尖）又猾（滑）
琉璃瓦盖鸡窝	大材小用
琉璃瓦盖寺庙	顶好
硫磺脑袋	点火就着
柳树出身	立场不稳
柳树的屁股	坐下就扎根
柳树开花	无结果；不结果
柳树上落凤凰	迟早要飞
柳条穿螃蟹	勾勾搭搭
柳条穿王八	一溜黑货
柳条篮子摇元宵	滚蛋
六个指头擦背	加一奉承
六个指头划拳	出了新招
六个指头挠痒	多一道子
六十岁尿床	老毛病
六十岁生娃娃	好事难盼
六月穿皮袄	自找罪受；反常
六月戴棉帽	不识时务
六月的斑鸠	不知春秋
六月的暴雨	一阵儿
六月的粪缸	越掏越臭
六月的荷花	众人共赏
六月的日头（太阳）	毒极了
六月的山	清（青）一色
六月的闪电	眨眼不见
六月的扇子	借不得
六月的天	说变就变；转眼就变；变化无常
六月的瘟猪	死不开口
六月的云，八月的风	难捉摸，捉摸不定
六月的云，少女的心	变化多端
六月飞霜	怪事一桩
六月里吃薄荷	凉透心；好良（凉）心
六月里吃生姜	服啦（伏辣）
六月里吃西瓜	甜在心上
六月里穿皮袄	反常；自找难受
六月里戴皮帽	乱套
六月里戴手套	保守（手）
六月里的梨疙瘩	有点酸
六月里的鱼汤	不动（冻）
六月里冻死羊	说来话长
六月天穿棉袄	不是好人
六月天晒裂了瓦	坏坯子
六月天身发抖	不寒而栗
六月天下雪	得之不易：难得
六月贴春联	还差半年
六指头拨琵琶	乱弹琴
六指头划拳	都来了
六指头上茶	格外巴结
龙背上刮鳞	痴心妄想
龙船装狗屎	又臭又长
龙灯的胡须	没人理
龙灯的脑壳	任人耍；由人摆布
龙灯耍得好	靠头儿
龙宫里造反	慌了神
龙门阵缺人	摆不起来
龙王长了个偏心眼	旱涝不均
龙王吹喇叭	神气
龙王管土地	管得宽
龙王靠边	人定胜天
龙王爷出海	兴风作浪
龙王爷出阵	翻江倒海
龙王爷打盹	百姓遭殃；四方遭灾
龙王爷打哈欠	好神气
龙王爷的帮手	虾兵蟹将
龙王爷的后代	龙子龙孙
龙王爷的帽子	道道多
龙王爷发怒	张牙舞爪；百姓遭难
龙王爷翻脸	要变天
龙王爷放火	改行
龙王爷招亲	水里来,水里去
龙王爷作法	呼风唤雨
龙王揍河神	自家人打自家人
龙嘴上拔胡须	送死；寻死；自己找死
砻糠（long kangg稻谷砻过后脱下的外壳）搓绳索	起头难；开头难
笼里的斑鸠	不知春秋
笼里捉鸡	十拿九稳
笼屉上抓馒头	稳拿
笼中的肥鸭	早晚得杀
笼中鸟，网中鱼	身不由己；不由自主；逃不了
笼子里的老虎	抖不起威风；难显威风
笼子里的鸟	有翅难飞
笼子里的鹦鹉	多嘴多舌
笼子里关蚂蚁	来去自由
笼子里过日子	睁眼净窟窿
笼子里抓小鸡	没跑；跑不了
聋哑人打官司	说不清；听不明
聋子打翻了哑巴的油瓶	说不清；听不明；说不清楚
聋子戴耳机	充耳不闻
聋子的耳朵	摆设；爱打岔；没用处
聋子放爆竹	散了
聋子放炮	充耳不闻；听而不闻
聋子见哑巴	不闻不问
聋子看戏	饱耳福
聋子擂鼓；瞎子敲锣	各打各的
聋子听戏；瞎子观灯	一无所获
娄阿鼠（昆剧《十五贯》中人物）测字	做贼心虚
娄阿鼠当县令	不是好官
楼顶上的警报器	事出有因（音）
楼上摆盆景	无地自容
搂草打兔子	捎带活
搂着金条睡觉	守财奴
漏斗盛水网兜风	一无所获
漏盆里洗澡	快活不多久
露水泡茶	得之不易；难得
卢沟桥的石狮子	数不清
芦柴秆做门闩	难撑
芦沟桥上石狮子	数不清
芦花做棉被	不是正胎子
芦苇墙上钉钉子	不牢靠
芦苇塞在竹简里	空对空
卤水点豆腐	一物降一物
卤煮寒鸭子	肉烂嘴不烂
鲁班的儿子学木匠	一代传一代；门里出身
鲁班的锯子	不错（锉）
鲁班的手艺	巧夺天工
鲁班门前卖手艺	忘了自个姓名
鲁班门前弄大斧	献丑；充内行
鲁班门前问斧子	讨学问来了
鲁肃服孔明	五体投地
鲁肃上了孔明船	尽办糊涂事
鲁智深出家	无牵无挂
鲁智深倒拔垂杨柳	好大的力气；蛮劲十足
碌碡（liu zhou石磙）碰碌碡	实（石）打实（石）
碌碡上拴镜儿	照常（场）
路边的芨芨草	看不上眼
路边的小草	任人践踏；由人踩
路边捡私生子	非亲非故
路边上的狗屎	不值一文（闻）
辘轳断了轴	玩不转
鹭鸶脚上挂蚂蚱	飞不了你；跑不了它
鹭鸶腿上劈精肉	没多大油水；无中生有
驴粪蛋上插花	臭美
驴粪蛋下霜	外光里不光
驴粪蛋子捏菩萨	坏了胎；胎里坏
驴粪蛋子	外面光
驴脸比母猪头	个比一个难看
驴脸和猪头	丑对丑；一对丑
驴皮煮胶	慢慢熬
驴屁股上的苍蝇	乱哄哄
驴踢房檐	谈（弹）不上
驴踢琵琶	乱弹琴
驴头插龙角	四不像
驴头上长角	怪事；怪事一桩
驴头伸过马食槽	插不上嘴；难插嘴
驴头伸进奶桶里	白吃
驴尾巴吊棒槌	累赘
驴子打滚	四脚朝天
驴子掉进阴沟里	乱谈（弹）
驴子拉磨牛耕田	各干一行；各走各的路；各干各的活
驴子听相声	茫然不懂
驴子下只象	怪胎
驴子削了耳朵	假骂（马）
吕布戏貂蝉	英雄难过美人关；上当受骗
吕洞宾打摆子	占先（颤仙）
吕洞宾讲故事	神话
吕蒙正盖房子	造谣（窑）
旅店里的臭虫	吃客
旅店里租被子	另搞一套
绿绸衫上绣牡丹	锦上添花
绿豆换米	各有一喜
绿豆里找红豆	难得；得之不易
绿头苍蝇	乱闯乱碰；见缝下蛆
绿头苍蝇下蛆	专找缝子钻；见缝就钻
孪生的娃娃	没大没小
乱弹琴	没谱
乱坟堆里找人	都是死硬货
乱坟岗上卖布	鬼扯
乱麻韭菜缠一起	难收拾；不可收拾
乱麻团缠皂角树	理不清
乱麻团掉刺窝	难理清
乱葬坟里掷骰子（tou zi游戏用具或赌具）	净是鬼点子；鬼点子多
乱葬坟上跳舞	鬼迷心窍
轮船开往亚非拉	四通八达；外行（航）
轮船上观海	无边无沿
轮船上泼水	随波逐流
轮胎上的气门芯	里外受气
罗锅（驼背）跌跟头	两头不着地
罗锅睡到碓窝（dui wo石臼）里	再合适不过了；合适
罗锅子（驼背）上树	钱（前）缺
罗汉请观音	客少主人多
萝卜当棒槌	不识货
萝卜地里栽韭菜	各人心里爱
萝卜雕观音	饮食菩萨
萝卜干当人参	不识货
萝卜青菜	各人所爱；各有所爱
萝卜上坟	骗鬼；哄死人
锣鼓喇叭一齐上	吹吹打打；又吹又打
锣鼓响器（唢呐）一起来	大吹大擂
箩筐盛石灰	处处留迹
箩头（箩筐）粪杈子	都是一家子，
骡子不下儿	理所当然
骡子的脸儿	非驴非马
骡子陪考	比劲大
螺丝帽上劲	尽绕圈子；弯弯绕
螺蛳壳里摆擂台	踢打不开
螺蛳壳里做道场	打不开场面
裸男坐石凳	以卵击石
裸女坐板凳	有板有眼
洛阳的牡丹	人人欢喜；个个喜爱
骆驼挨鞭子	忍辱负重
骆驼安鼻子	装相（象）
骆驼吃蚂蚁	小收拾
骆驼打跟头	两头不着实
骆驼的脖子，鸵鸟的脚	各有所长
骆驼蹬蹄	没法治；没治了
骆驼过独木桥	步步有险；一步三分险
骆驼进鸡窝	没门
骆驼进牛棚	门路不对
骆驼进羊圈	不入门
骆驼撒欢	汉个正经样
骆驼身上拔根毛	无伤大体；无足轻重
骆驼生驴子	怪胎
骆驼推磨	大手大脚
骆驼下骡子	怪种
骆驼想吃隔山草	妄想；痴心妄想
骆驼在沙漠里断了水	进退两难
骆驼走路	昂首阔步
落地的柿子	软瘫了；软作一堆
落地的水银	无孔不入。
落蒂的香瓜	熟透了
落锅的虾子	还想跳几下
落花满地红	多谢多谢，
落了三年黄梅雨	绝情（晴）
落水的鸡毛	飞不起来
落水的桃花	随波逐流
落汤的螃蟹	手忙脚乱
落雪天过冰大坂（ban山坡；斜坡）	从头凉到脚
落雨打土坯	没有好货
落雨躲进山神庙	轮（淋）不着
落雨立当院	轮（淋）到头上．
落雨天出太阳	假情（晴）
落雨天打砖	坏坯子
落雨天担禾草	担子越来越重
落在陷阱里的骏马	寸步难行
麻包里装钉子	露头
麻布补西装	半土半洋；土洋结合
麻布厂遭火灾	烧包
麻布袋里的菱角	硬要钻出来
麻布袋绣花	底子太差（比喻基础不好。）
麻布袋做龙袍	不是这块料
麻布片绣花	白费劲
麻布手巾绣牡丹	配不上；不配
麻布下水	柠不干
麻布鞋上镶绸子	不成体统
麻袋换草袋	一代（袋）不如一代（袋）
麻袋里的菱角	个个想出头
麻袋里装猪娃	不知黑白
麻袋片上绣花	一代（袋）不如一代（袋）
麻袋绣花	底子差；基础差；粗中有细；底子不行
麻袋做龙袍	不是这块料
麻风病人长恶疮	毒上加毒
麻杆打老虎	不痛不痒
麻秆搭架子	难顶难撑
麻秆搭桥	难过；担当不起
麻秆打狼	两面怕；两头怕
麻秆手仗	靠不住；不可靠
麻秆做扁担	担当不起；不是正经材料
麻秆做床腿	难撑
麻秆做屋梁	无用之材
麻姑娘搽雪花膏	观点模糊
麻花儿上吊	脆鬼
麻黄汤发汗	茅（毛）塞顿开
麻秸秆做扁担	挑不起重担；难挑担
麻秸秆做笛子	吹不得；别吹了
麻茎当秤杆	没个准儿
麻柳树解板子	不是正经材料
麻面姑娘爱搽粉，瘌痢姑娘爱戴花	臭美
麻婆照镜子	自找难看；个人观点
麻雀搬家	唧唧喳喳
麻雀抱蛋	白欢喜；空喜一场
麻雀吃不下二两谷	肚量小
麻雀搭窝	各顾各
麻雀当家	七嘴八舌
麻雀的肚腹	小心眼；心眼狭小
麻雀的内脏	小心肝
麻雀掉到面缸里	煳（糊）嘴
麻雀掉在面缸里	糊嘴
麻雀斗公鸡	自不量力
麻雀肚子鸡子眼	吃不多，看不远
麻雀剁了身子	光剩嘴
麻雀屙（e 排泄）屎大过箩	大话；讲大话
麻雀飞大海	没着落
麻雀飞到旗杆上	鸟不大，架子倒不小
麻雀飞到糖堆上	空欢喜
麻雀飞进照相馆	见面容易说话难
麻雀跟着蝙蝠飞	白熬夜
麻雀鼓肚子	好大的气
麻雀嫁女	唧唧喳喳;小打小闹
麻雀开会	细商量
麻雀落糠堆	空欢喜；空喜一场
麻雀落在牌坊上	东西不大，架子不小
麻雀入了瞎猫口	不死也要脱层皮
麻雀入笼	飞不了
麻雀生鸡蛋	办不到；没法办
麻雀虽小	肝胆俱全（比喻小而齐全，具有典型意义）
麻雀头包饺子	尽是嘴
麻雀窝里落喜鹊	长不了；早晚要飞
麻雀洗澡	团团转
麻雀下鹅蛋	太话；讲大话；瞎逞能；不可能的事；没有见过
麻雀想和鹰打架	不是对手
麻雀想学凤凰飞	枉费心机
麻雀饮河水	干不了
麻雀炸窝	阵脚大乱
麻雀追飞机	枉费心机
麻雀啄鸡子儿（鸡蛋）	捣蛋
麻雀啄米汤	煳（糊）嘴
麻绳穿绣花针	难通过；通不过
麻绳穿针	钻不进
麻绳串豆腐	提不起来
麻绳吊鸡蛋	两头脱空
麻绳上按电灯泡	搞错了线路
麻绳上扯电灯	搞错了路线；路线错了
麻绳上拉电灯	路线错了
麻绳拴豆腐	提不起
麻绳蘸水	紧上加紧
麻绳蘸盐水	越来越紧
麻媳妇拜见歪嘴婆	丑对丑；一对丑
麻线穿针	钻不进
麻线穿针眼	过得去就行
麻线搓绳	合在一起干
麻丫头照镜子	点子多；点子不少
麻油拌小菜	个个喜爱；人人都喜爱
麻油炒白菜	各人心中爱
麻油炒豆腐	不惜代价
麻油煎豆腐	下了大本钱
麻子不叫麻子	坑人
麻子的脸	尽是缺点
麻子掉枯井	坑人不浅
麻子管事	点子多；点子不少
麻子敲门	坑人到家了（比喻为非作歹，害人已极。）
麻子跳伞	天花乱坠
麻子照相	脸上不好看
马背上的剧团	载歌载舞
马背上跌跤，牛背上抽鞭	错上加错；迁怒于人
马背上钉掌	离题（蹄）太远；不贴题（蹄）
马背上接电话	奇（骑）闻
马背上看书	走着瞧
马脖子上挂铜铃	走到哪，响到哪
马不停蹄，鞭不停挥	老赶
马槽边上的苍蝇	混饭吃
马槽里的苍蝇	混饭吃
马槽里伸出个驴头	多嘴多舌；多一张嘴
马长犄解骡下驹	怪事一桩；怪事
马车过沼泽地	此路不通
马大哈当会计	全是糊涂帐
马到悬崖不收缰	死路一条
马蹬子钉掌	空前绝后
马放南山，刀枪入库	天下太平
马粪球，羊屎蛋	外光里不光；表面光
马蜂的屁股	碰不得；摸不得
马蜂过河	带（歹）毒
马蜂口丁屁股	痛不可言
马蜂窝，蝎子窝	一窝更比一窝毒
马蜂窝	捅不得
马蜂蜇秃子	头痛；没遮没盖
马蜂蜇蝎子	以毒攻毒
马蜂针，蝎子尾	惹不起
马高镫短	上下两难；上下为难
马褂改裤衩儿	大材小用
马褂改棉袄	老一套
马虎（民间传说中形象丑陋、吞食小孩的怪物）看小孩	不放心；放心不下
马鲛鱼	嘴硬骨头酥
马嚼子套在牛嘴上	胡勒
马拉车驾辕	不合套
马拉车尥蹶子（liao jue zi）	乱了套；乱套了
马拉独轮车	说翻就翻；翻了
马拉九鼎	拽（zhuai拉）不动
马拉汽车	新鲜事
马来西亚的咖啡	耐人寻味
马脸比猪头	当面出丑；一个比一个丑
马列主义装到电简里	照见别人，照不见自己；照人不照己
马笼头给牛戴	生搬硬套
马笼头套在牛嘴上	胡勒
马路不拐弯	正直公道
马路不叫马路	公道（①比喻公正。②公平、合理。）
马路旁的电杆	靠边站
马路上安电灯	光明大道
马路上的传单	白给
马路上跑火车	不合辙
马路上说马路	公道
马皮拧绳绳拴马，牛皮做鞭鞭打牛	忘本
马屁股上挂蒲扇	拍马屁
马屁精拍了马腿	倒挨一脚
马圈里的骡子	听喝的，
马群里的骆驼	突出
马上耍杂技	艺高胆大
马勺当锣打	穷得丁当响
马勺里淘菜	水泄不通
马勺碰锅沿	常有的事（比喻屡见不鲜。）
马勺掏耳朵	不深人；深不下去
马食槽边点盏灯	照料
马食槽不许驴插嘴	独吞
马蹄长瘤子	无关痛痒；不痛不痒
马蹄刀瓢里切瓜	滴水不漏；点滴不漏
马跳水浪	奔波
马桶倒进臭水沟	同流合污
马桶里倒香水	香臭不分；香臭难分
马桶拼棺材	臭了半辈子还装人
马桶上长鹿角	四不像
马脱缰绳鸟出笼	永不回头；决不回头
马尾巴拌豆腐	捣乱
马尾巴提豆腐	串不起来
马尾绷琵琶	不值一谈（弹）
马尾穿豆腐	没法提；提不得；别提了
马尾穿萝卜	粗中有细
马尾搓绳	不合股；合不了股；用不上劲
马尾拉胡琴	细声细气
马尾拴鸡蛋	难缠
马戏团的猴子	任人耍；由人玩耍
马戏团的小丑	走过场
马陷淤泥	进退两难
马捉老鼠	不务正业；不干正经事
马走日字象走田	各有各的路
码头上的吊车	能上能下
蚂蝗的身子	软骨头
蚂蝗见血	叮（盯）住不放（比喻集中视力看。）
蚂蟥吃萤火虫	心里亮；肚里明
蚂蟥的身子	软骨头
蚂蟥叮住鹭鸶脚	生死同飞；难脱身；挣不脱；盯（叮）住不放
蚂蟥叮住螺蛳脚	抓住不放
蚂蟥叮住水牛腿	寸步不离
蚂蟥钻进牛鼻孔	难解脱
蚂蜗（ma quai青蛙）上墙	巴不得
蚂虾（小虾）剁馅子	少头无尾
蚂虾尥蹶子（liao jue zi）	小踢蹬
蚂蚁搬秤砣	白费功夫；白费劲；枉费功
蚂蚁搬虫子	个个使劲
蚂蚁搬家	拖拖拉拉；大家动口；倾巢出动（洞）
蚂蚁搬磨盘	枉费心机
蚂蚁搬泰山	瞎逞能；自不量力；不自量
蚂蚁背螳螂	肩负重任
蚂蚁背田螺	假充大头鬼
蚂蚁脖子戳一刀	不是出血的筒子
蚂蚁吃萤火虫	亮在肚里
蚂蚁打哈欠	好大的口气；小气
蚂蚁打群架	自相残杀
蚂蚁戴谷壳	好大的脸皮
蚂蚁戴眼镜	好大的脸皮
蚂蚁挡道儿	颠不翻车（比喻无关大局。）
蚂蚁的腿，蜜蜂的嘴	闲不住；一天忙到晚
蚂蚁的嘴	吃里爬外
蚂蚁掉进擂钵里	条条是道；条条是路；路子多
蚂蚁抖腿	小踢蹬
蚂蚁关在鸟笼里	门道很多
蚂蚁撼大树	自不量力；不自量；纹丝不动
蚂蚁喝水	点滴就够啦
蚂蚁回窝	走老路
蚂蚁讲话	碰头（比喻见面、相遇。）
蚂蚁进牢房	自有出路
蚂蚁看天	不知高低
蚂蚁扛大树	不自量
蚂蚁扛螳螂	重任在肩；肩负重任
蚂蚁啃骨头	慢慢来；白费功夫；白费劲；精神可嘉
蚂蚁啃旗杆	吃不消，攻不倒
蚂蚁啃象鼻	不识大体
蚂蚁拉火车	纹丝不动
蚂蚁拉石磙	力不能及；力不从心；心有余而力不足
蚂蚁尿湿柴	不值一提
蚂蚁尿书本	识（湿）字不多
蚂蚁爬簸箕	路子多
蚂蚁爬皮球	无边无沿
蚂蚁爬扫帚	条条是道；条条是路；路子多
蚂蚁爬树	七上八下；接连不断
蚂蚁碰上鸡	活该
蚂蚁身上长疖子	浑身是病
蚂蚁身上砍一刀	浑身是伤
蚂蚁生疮	小毛病
蚂蚁抬虫子	个个使劲；齐心合力
蚂蚁抬大炮	担当不起
蚂蚁抬食	步调一致
蚂蚁抬土	一窝蜂
蚂蚁头上戴斗笠	乱扣帽子
蚂蚁头上砍一刀	没血肉
蚂蚁拖秤砣	难上加难
蚂蚁拖耗子	心有余而力不足
蚂蚁驮秤砣	好大的口气
蚂蚁下塘	不知深浅
蚂蚁缘槐夸大国	小见识
蚂蚁抓上牛角尖	自以为上了高山
蚂蚁嘴碾盘	嘴上的劲
蚂蚱打喷嚏（pen ti）	好大的口气
蚂蚱打食（找食）	紧顾嘴
蚂蚱戴笼头	假充大牲口；好大的脸面
蚂蚱斗公鸡	自不量力
蚂蚱看庄稼	越看越光
蚂蚱爬在鞭梢上	经不起摔打
蚂蚱配蝗虫	门当户对
蚂蚱上豆架	借大架子吓人；小东西借大架子吓人
蚂蚱跳塘	不知深浅
蚂蚱头摆碟子	尽是嘴
蚂蚱头炒盘菜	多嘴多舌
蚂蚱腿上刮精肉	难下手；无法下手
蚂蚱驮砖头	招架不住
骂了皇帝骂祖先	不忠不孝
骂人挖祖坟	欺人太甚；太欺负人
埋好的地雷	一触即发
埋下的地雷	一触即发
买把韭菜不择	抖起来了
买豆腐花肉价钱	不上算；不合算
买个喇叭不透气	实（石）心眼
买盒还珠	不识货（比喻没有眼光，取舍不当。）
买回彩电带回发票	有根有据
买金的遇见卖金的	正合适
买老牛置破牛	光顾眼前；只顾眼前
买了麻花不吃	要的就是这个劲儿
买了相因（便宜）柴，烧了夹生饭	想占便宜反吃亏
买帽子揣到怀里	不对头
买面的进了石灰店	走错了门；找错了门
买匹布裹脚	宽打窄用
买石头砸锅	自寻倒灶
买死鱼放生	荒唐；不知死活
买头瘦驴老掉牙	自骑自夸
买咸鱼放生	尽做冤枉事
买鱼放生	菩萨心肠
买只羊羔不吃草	毛病不少
麦场上挂马灯	照常（场）
麦秆吹火	小气（器）；气（器）不大
麦秆儿当秤	没斤没两
麦秆里睡觉	细人
麦秆做吹火筒	小气（器）
麦秸秆里看人	小瞧
麦秸装枕头	草包
麦糠擦屁股	自找麻烦
麦糠搓绳	接不上茌
麦克风前吹喇叭	里外响
麦克风前拉二胡	弦外之音；弦外有音
麦粒掉到太平洋里	沧海一粟
麦芒穿针眼	难得；得之不易
麦芒掉进针眼里	凑巧了；赶得巧；正好
麦苗当成韭菜割	胡拉乱扯
麦田里种棉花	一举两得
麦田捉鳖	十拿九稳
麦田捉田鸡	手到擒来
麦子未熟秧未插	青黄不接
卖鞭炮的炸了手	自作自受
卖冰棒的进茶馆	一冷一热；忽冷忽热
卖不出去的狐狸皮	骚货
卖布不用尺	胡扯
卖炒勺的	拣有把握的来
卖醋卖糖	各管一行
卖豆腐带种河滩地	水里来，水里去
卖豆腐的扛台脚	生意不大架子大
卖豆芽的不带秤	乱抓
卖豆芽的抖搂筐	干净利索
卖房卖地置嫁妆	下尽本钱
卖瓜的夸瓜甜，卖鱼的夸鱼鲜	自卖自夸
卖棺材的跺脚	恨人不死
卖棺材的咬牙	恨人不死
卖孩子唱大戏	庆的什么功
卖胡琴的碰上卖布的	拉拉扯扯
卖花圈的咬牙	恨人不死
卖花人说花贵，卖茶人说茶芳	各有一套
卖花人说花艳，卖菜人讲菜鲜	自卖自夸
卖花生的不用秤	估堆
卖灰面（面粉）遇大风	倒霉透了；真倒霉
卖鸡蛋的跌跤	完蛋；滚蛋
卖鸡子儿（鸡蛋）的换筐篮	捣（倒）蛋
卖煎饼的赔本	贪（摊）大了
卖糨糊的敲门	糊涂到家了
卖裤子打酒喝	顾嘴不顾身
卖了儿子招女婿	颠倒着做；胡折腾
卖了麦子买蒸笼	不蒸馒头争（蒸）口气
卖了犬褂买裤衩	短得见不了人
卖了生姜买蒜吃	换换口味
卖了鞋子买帽子	顾头不顾脚
卖了衣服买酒喝	顾嘴不顾身
卖绿豆搀珍珠	不上算；不合算
卖馒头的搀石灰	面不改色
卖帽子的喊卖鞋	头上一句，脚下一句
卖煤的跟个狗	净吃闲饭
卖门神掉江里	人财两空
卖米不带升	存心不良（量）
卖木脑壳（木偶）被贼抢	大丢脸面
卖木脑壳被贼抢	大丢脸面
卖牛卖地娶回个哑巴	没话可说；无话说
卖牛肉的面孔	斤斤计较
卖螃蟹的上戏台	角（脚）色不少，能唱的不多
卖肉的切豆腐	不在话下
卖沙锅的摔跤	砸锅
卖石灰碰见卖面的	谁也见不得谁
卖水的看大河	全是钱
卖汤圆的跌跟头	倾家荡产
卖糖人的出身	吹出来的；靠吹
卖糖稀（含水分较多的麦芽糖）的盖楼房	熬出来的
卖瓦盆的进货	一套一套的
卖瓦盆的摔跟头	乱了套
卖完孩子唱大戏	庆的什么功
卖西瓜的碰到卖王八的	滚的滚，爬的爬；连滚带爬
卖虾的不拿秤	抓瞎（虾）
卖香囊掉泪	睹物伤情
卖盐的喝开水	没味道
卖油的梆子	挨敲打的货
卖油的不打盐	不管闲（咸）事
卖油的敲锅盖	好大的牌子
卖油条的拉胡琴	游（油）手好闲（弦）
卖杂货的洗手不干	撂（liao放；搁）挑子
馒头里包豆渣	人家不夸自己夸
馒头做枕头	不愁吃
鳗鱼死在汤罐里	冤屈（圆屈）死了
满船豆腐抛下江	水里来，水里去
满地丢西瓜，撅腚（ding臀部）捡芝麻	不知轻重
满姑娘（最小的姑娘）的荷包	花样多
满街挂灯笼	光明大道
满口镶金牙	嘴里漂亮
满面鸡虱子乱爬	脸上尴尬（qan qa）
满脑壳长疮钻刺窝	自讨苦吃
满山跑的兔子不回窝	野惯了
满堂儿孙	后继有人
满天飞乌鸦	漆黑一片；一片黑
满天浮动的云霞	经不起风吹雨打
满园的萝卜	个个想出头
满园的牡丹	讨人爱；爱煞人
满园落地花	多谢
满嘴假牙齿	吃软不吃硬
满嘴跑舌头	爱说啥说啥
满嘴塞黄连	说不出的苦
满嘴镶金牙	开黄腔
漫地里烤火	一面热
漫山的杜鹃	红火的一片；一片红火
忙中拾得一包针	谁顾得数你
盲佬射箭	目的不明
盲驴拉磨	瞎转圈
盲驴下河	瞎扑腾
盲人剥蒜	瞎扯皮
盲人不问路	瞎碰；瞎撞
盲人打靶	缺乏目标；没有目标
盲人戴眼镜	假聪（充）明
盲人当警察	瞎指挥；用人不当
盲人的拐棍	寸步不离；瞎指点
盲人的眼珠子	目中无人
盲人读书	瞎摸
盲人翻跟斗	瞎折腾
盲人纺纱	瞎扯
盲人放枪	无的放矢
盲人干活	不分日夜
盲人赶庙会	瞎凑热闹
盲人给盲人带路	瞎扯
盲人救火	瞎扑打
盲人看三国（《三国演义》）	装模作样；装样子
盲人拉二胡	瞎扯
盲人拉风箱	瞎鼓捣
盲人聊天	瞎话
盲人摸象	不识大体；各有偏见；各执一词
盲人骑毛驴	随它去；由它去
盲人骑瞎马	乱闯乱碰；听天由命；寸步难行
盲人敲鼓	瞎打一阵
盲人上大街	目中无人
盲人耍把势	硬逞能；瞎逞能
盲人谈心	瞎说
盲人提喇叭	瞎吹
盲人推磨子	瞎转圈
盲人捂耳朵	闭目塞听
盲人熄灯	瞎吹
盲人学绣花	瞎逞能
盲人粘字画	倒贴
盲人捉虱子	瞎抓挠
盲人走路	分不清东南西北
盲人坐阵	瞎指挥
蟒蛇缠犁头	狡猾（绞铧）
蟒蛇缠身	挣不脱
蟒蛇进鸡窝	完蛋
猫被老虎撵上树	多亏留一手
猫不吃咸鱼	假正经；假装正经
猫吃狗屎	不对味；不是味儿
猫吃鸡肠子	越扯越长
猫逮老鼠鼠打洞	各有本领；各靠各的本事
猫肚子放虎胆	凶不起来
猫额上画王字	虎头虎脑
猫儿扒琵琶	乱弹琴
猫儿扳到甑子（zen gzi蒸米饭等的器具）	狗得福
猫儿不吃腥	冒充斯文；假斯文
猫儿吃豆渣	不对味；不是味儿
猫儿洞口等老鼠	目不转睛
猫儿念经	假充善人
猫儿食，耗子眼	吃不多，看不远
猫儿守老鼠洞	不动声色
猫儿偷食狗挨打	无辜受累
猫儿洗脸	一扫光
猫儿抓心	难受
猫给耗子拜年	没安好心；来者不善
猫给老鼠吊孝	虚情假意；假仁假义
猫狗打架	世代冤家
猫教老虎	留一手
猫教老虎上树	天下奇闻；无奇不有
猫教徒弟	留一手
猫啃尾巴	自吃自；自咬自
猫哭老鼠	假慈悲；假慈善；假伤心
猫撂（liao弄倒）黄狗	不是对手
猫爬屋脊	到顶了
猫披虎皮	抖威风；好了不起
猫守鼠洞	不动声色
猫舔狗鼻子	自讨没趣；自找没趣
猫头鹰报喜	丑名（鸣）在外
猫头鹰唱歌	瞎叫唤
猫头鹰打瞌睡	睁只眼，闭只眼；装迷糊
猫头鹰抓耗子	干好事，落骂名
猫尾巴，狗尾巴	越摸越翘
猫窝里藏干鱼	靠不住；不可靠
猫窝里的泥鳅	留不住；难久留
猫戏老鼠	哄着玩
猫咬刺猬	无从下口；难下口
猫咬老虎	冷不防
猫抓糍粑	撕扯不清；脱不了爪
猫爪伸到鱼池里	想捞一把
猫爪伸到鱼缸里	想捞一把
猫捉老鼠狗看门	各尽其责；各尽其职；本分事；分内事
猫捉老鼠	拿手好戏；祖传秘方；一物降一物
猫嘴里的老鼠	跑不了；剩不了啥
猫嘴里塞鲤鱼	投其所好
猫嘴里掏泥鳅	夺人所好
毛笔掉了头	光棍一条；光棍
毛玻璃做灯罩	半明半不明
毛豆烧豆腐	碰上自家人
毛猴子拉车	乱了套；乱套了
毛猴子捞月亮	白忙一场
毛驴备银鞍	配不上；不配
毛驴钉马掌	小题（蹄）大做
毛驴啃石磨	好硬的嘴
毛驴碰门	来的不是人
毛驴上套	屎尿多
毛驴下骡子	变种
毛驴笑人耳朵长	不知自丑
毛驴子拉磨	兜圈子；原地打转
毛毛虫弓腰	以屈求伸
毛笋脱壳	节节高；节节上升
毛袜套毡袜	不分彼此
毛竹扁担挑泰山	担当不起
茅草秆打狗	软弱无力
茅草棚里摆沙发	配不上；不配
茅草窝里的毒蛇	暗中伤人
茅厕（mao ce厕所）搭牌楼	臭架子；摆臭架子
茅厕里安电扇	臭吹
茅厕里吃馅饼	亏你张得开嘴
茅厕里打瞌睡	离死（屎）不远
茅厕里桂花开	香香臭臭
茅厕里铺地毯	臭讲究
茅厕里失火	臭气熏天
茅房里打躬（作辑）	臭奉承
茅房里的大粪蛆	死（屎）里求生
茅房里的旧马桶	嘴滑肚臭
茅房里题诗	臭秀才
茅缸里泡豆芽	腌�H（a za肮脏；不干净）菜
茅坑里板子做棺材	臭了半辈子还装人
茅坑里的搅屎棍	文（闻）不能文（闻），武（舞）不能武（舞）
茅坑里的蛆	无孔不入
茅坑里的石头	又臭又硬；臭硬
茅坑里搁暖壶	臭水平（瓶）
茅坑里捡铜板	臭钱
茅坑里啃西瓜	不对味；不是味儿
茅坑里洒香水	多此一举
茅坑上边盖大厦	臭底子；底子臭
茅覃补柱子	无济于事
茅屋上安兽头	不相称
冒烟的手榴弹	摸不得
帽沿儿做鞋垫	一贬到底
帽子里藏知了	头名（鸣）
帽子里搁砖头	头重脚轻
帽子没沿	顶好
帽子抛空中	欢喜若狂
帽子上面戴斗笠	官（冠）上加官（冠）
帽子涂蜡	滑头：滑头滑脑
没安头的锄杠	光棍一条
没把的茶壶	光剩嘴
没帮的破鞋	没法提；提不得；别提了
没病抓药	自讨苦吃
没吃三两煎豆腐	称什么老斋公
没等开口三巴掌	不由分说
没底的棺材	成（盛）不了人
没干的生漆	近不得
没跟的鞋子	拖拖沓沓；没法提；提不起来；别提了
没骨子的伞	支撑不开
没框的算盘珠	散了
没笼头的牲口	野惯了；无拘无束
没路标的三岔口	左右为难
没轮子的牛车	跑不了
没买马车先置鞍	弄颠倒了；颠倒着做
没娘的孩子	无家可归
没钱花拍桌子	穷横；穷凶极恶
没桥顺河走	绕来绕去
没切开的西瓜	红白不分
没上套的磨道驴	空转一遭
没事喧瓜子	吞吞吐吐
没事找枷扳	自找难受
没事找枷板	自找罪受；自找难受
没水吃渴死人	与我（饿）无关
没睡打呼噜	装迷糊
没头的苍蝇	瞎起哄；乱撞
没头的蚂蚱	瞎蹦
没头发却要辫子税	无辜受罪
没牙老婆吃胡豆	软磨硬顶
没牙老婆吃面筋	拉拉扯扯
没牙老婆嚼牛筋	白磨嘴皮
没沿的破筛子	千孔百疮
没眼的笛子	吹不响
没眼儿判官	瞎鬼
没眼儿猪跟着狗叫唤	瞎起哄
没眼儿猪叫	瞎哼哼
没眼判官进赌场	瞎鬼混
没眼先生上钟楼	瞎碰；瞎撞
没有边的草帽	顶好
没有缝的鸡蛋	无懈可击
没有金刚钻	别揽瓷器活准
没有笼头的野牛	到处伸嘴
没有砣的秤	不知轻重
没准星的炮	乱轰
没罪找枷戴	自寻烦恼
眉毛吊磨盘	有眼力
眉毛胡子	把抓
眉毛胡子一把抓	主次不分
眉毛上安灯泡	明眼人
眉毛上插花	有眼色
眉毛上长牡丹	看花了眼；花了眼
眉毛上搭梯子	放不下脸
眉毛上荡秋千	太悬乎
眉毛上放爆竹	祸在眼前
眉毛上挂灯	心明眼亮
眉毛上挂帘子	不显眼
眉毛上挂炮仗（爆竹）	急在眼前；祸在眼前
眉毛上挂猪胆	苦在眼前
眉毛上掐虱子	有眼色（虱）
眉毛上失火	红了眼
梅兰芳唱（霸王别姬》	拿手好戏
梅香（泛指婢女）拜把子（朋友结为异姓兄弟）	全是奴才
梅香拜把子	都是奴才
梅香照镜子	一副奴才相
媒婆夸姑娘	说得象仙女
媒婆夸闺女	光拣好的说
媒婆迷了路	没说的
媒婆提亲	净拣好听的说
媒婆子的嘴	能说会道；天花乱坠
媒婆子烂嘴	口难张
媒婆子嘴长疮	难开口；不好开口
煤堆里找芝麻	难寻；难得；得之不易
煤堆上落汤圆	吹也吹不得；拍也拍不得
煤粉石灰搀一起	黑白不分；混淆黑白
煤粉子捏菩萨	黑心肝；心肠黑
煤灰刷墙壁	一抹黑
煤块掉在雪地上	黑白分明
煤面子捏的人	黑心肝
煤铺的掌柜	赚黑钱
煤炭下水	一辈子洗不清
煤窑里放瓦斯	害人不浅
霉烂的冬瓜	一肚子坏水
霉烂的栗子	黑心；黑了心
霉烂了的莲耦	坏心眼
霉烂了的莲藕	坏心眼
美女嫁痴汉	凑合着过；混着过
美玉埋在狗屎堆里	可惜；真可惜
妹妹穿姐姐的鞋	一模一样；没什么两样
妹妹贴对联	不分上下
媚眼做给瞎子看	自作多情；没人领情；不领情
门板上画个鼻子	好大的脸皮
门背后挂死人	提心吊胆
门洞里敲锣鼓	里外响
门缝里夹鸡子儿（鸡蛋）	完蛋
门缝里看大街	眼光狭窄
门缝里瞧人	把人看扁了
门缝里瞧西瓜	原（圆）形毕露
门旮旯里伸拳头	使暗劲；暗中使劲
门槛上剁萝卜	一刀两断（段）
门槛上砍索索（绳子）	一刀两断（段）
门槛上拉车	进退两难、
门槛上拉屎	里外臭
门槛上面切藕	藕断丝连
门槛下的砖头	踢进踢出
门角安电扇	背地里扇
门角里藏着诸葛亮	暗中盘算
门角里晾衣裳	阴干
门旯旯（ga la角落）里的簸箕	背地里扇
门里出身	强人三分；自会三分
门里金刚	自高自大
门里头打跟头	门外出身
门楼上挂红灯	高明
门上的封条	扯不得；莫扯
门上贴春联	一对红
门神卷财神	话（画）里有话（画）
门神揍灶神	自家人打自家人；自打自
门头沟打官司	没（煤）的事
门外吹喇叭	想（响）得开
猛虎闯羊群	一团糟；一片混乱
猛火烤烧饼	不出好货
猛将军出征	不获全胜不收兵
猛将军骑马	一跃而上
猛将军上阵	勇往直前
猛张飞舞刀	杀气腾腾
蒙面人出场	不留脸面
蒙上眼睛架电线	瞎扯
蒙上眼睛拉磨	瞎转悠
蒙上眼睛卖豆芽	瞎抓
蒙在被子里放屁	自作自受
蒙住眼睛圭咱	不行正道
蒙着被子放屁	独吞
蒙着脸找婆娘	不知丑俊
蒙着脑袋走棋子	轻举妄动
蒙着眼睛哄鼻子	自欺欺人
梦见鸡蛋上楼梯	奇又奇；奇了
梦里搽胭脂	尽想好事
梦里吃蜜	想得甜
梦里打牙祭（偶尔吃顿丰盛的饭）	想得香
梦里戴凤冠	想得倒美
梦里吊颈	想死
梦里对媳妇	想得倒美
梦里见黄连	想苦了
梦里结婚	好事不成
梦里啃甘蔗	想得倒甜
梦里娶媳妇	高兴一时是一时；快活一时算一时
梦里失火喊救命	虚惊一场
梦里拾钞票	财迷心窍
梦里坐飞机	想头不低；想得高
梦里做皇上	快活不了多久
梦中聚餐	嘴馋
梦中吞象	野心勃勃；野心太大
梦中游太空	想人非非（飞飞）
梦中游西湖	好景不长
弥勒佛吹螺号	一团和气
弥勒佛管山门	自得其乐
迷失方向的帆船	随波逐流
迷途的羔羊	无家可归
迷途的信鸽	没着落
迷途望见北斗星	绝处逢生
米粑粑粘砂糖	难舍难分
米仓里的老鼠	不愁吃；不愁没吃
米尺量太阳	光芒万丈
米醋做冰棍	寒酸
米烂在锅里	没关系
米箩里跳到糠箩里	越来越糟
米满粮仓人饿倒	舍命不舍财；爱财舍命
米筛挡房门	心眼多；心眼不少
米筛子当玩具	耍心眼
米筛子筛豆子	格格不入
米数颗粒麻数根	小气鬼；小气
米汤炒莲藕	糊了眼
米汤浇身	糊涂人
米汤泡稀饭	亲（清）上加亲（清）
米汤洗脚，糨子（jiang糨糊）搽脸	糊涂一生；一世糊涂
米汤洗头	糊涂到顶了
米汤煮芋头	糊里糊涂
眯缝着眼看斜纹布	思（丝）路不对
密封船下水	开口是祸
密网捕鱼	连窝端
蜜蜂的屁股	刺儿头
蜜蜂的窝	窟窿多
蜜蜂的眼睛	突出
蜜蜂叮镜中花	白费功夫
蜜蜂叮在玻璃窗	看到光明无出路；没出路
蜜蜂飞到彩画上	空欢喜
蜜蜂酿蜜	为别人操劳
蜜蜂窝	窟窿
蜜蜂蛰人	逼急
蜜罐子嘴	说得甜
蜜饯黄连	同甘同苦
蜜饯石头子儿	吃不消；好吃难消化
蜜里调油	又甜又香
蜜糖罐子打醋	不知酸甜
蜜糖抹在鼻尖上	看不到，吃不着
蜜糖嘴巴刀子心	阴毒
绵羊摆在案板上	任人摆弄
绵羊的尾巴	油水多；翘不起来
绵羊结伙	三三两两
绵羊进狼窝	自投罗网
绵羊跑到驴群里	充大个儿
绵羊走到狼群里	胆战心惊；战战兢兢
棉袄改被子	两头够不着
棉袄改皮袄	越变越好
棉袄换皮袄	越变越好
棉花包里的针	暗中伤人
棉花槌打鼓	没音
棉花槌打驴	无关痛痒；不痛不痒
棉花地里种芝麻	一举两得
棉花店打烊（dayang晚上关门停止营业）	不谈（弹）了
棉花堆里藏铁砣	不知轻重；虚虚实实
棉花堆里藏珍珠	内中有宝
棉花堆里找跳蚤	没着落
棉花堆里整人	软收拾
棉花堆失火	没救
棉花耳朵	根子软；经不起吹
棉花裹秤砣	柔中有刚；软中有硬
棉花换核桃	吃硬不吃软
棉花卷儿打锣	没有音；没音
棉花卷儿找锣	没回音
棉花棵上结板栗	就数它硬
棉花里藏针	柔中有刚
棉花里搀柳絮	弄虚作假
棉花铺失火	谈（弹）不得；无法谈（弹）
棉花人救火	自身难保
棉花塞住了鼻子	憋得难受
棉花湿了水	不谈（弹）了
棉花摊在蒺藜（ji li一年生草本植物。果皮有尖刺）窝	难收拾；不可收拾
棉花套上晒芝麻	自找麻烦
棉花做秤砣	没多少斤两
棉裤没有腿	凉了半截
棉纱线牵毛驴	不牢靠
棉条打鼓	没多大响声；不想（响）
面粉搀石灰	密不可分
面疙瘩补锅	抵挡一阵
面疙瘩掉在肉锅里	混（浑）蛋
面筋放在油锅里	越大越空
面筋粘知了	没跑；跑不了
面具店里失盗	丢脸
面汤锅里洗澡	糊涂人
面汤锅里煮灯泡	说他混蛋，他还一肚子邪火
面汤里煮皮球	说他混蛋，他还一肚子气
面条点灯	犯（饭）不着
面条锅里下笊篱（zhho li捞取东西的用具。用金属丝、竹蔑或柳条等编成。有长柄）	想捞一把
描金箱子白铜锁	外面好看里面空
庙背后看神	妙（庙）透了
庙后叩头	心到神知
庙会上舞狮子	任人耍；由人玩耍
庙里的佛爷	脸上贴金；有眼无珠
庙里的鼓	人人打得
庙里的观音	站得住脚
庙里的和尚	无牵无挂
庙里的金刚	大显神威
庙里的马	精（惊）不了
庙里的木鱼	天生挨揍
庙里的泥像	有人样，没人味
庙里的钟	声大肚里空
庙里丢菩萨	失神
庙里赶菩萨	神出鬼没
庙里旗杆冒烟	烧高香
庙里头放屁	熏爷爷来了
庙门前的旗杆	光棍一条
庙门前的石狮子	一对儿；龇（zi）牙咧嘴
庙门上筛灰	槽踏神像
庙台上长草	慌（荒）了神
庙堂里的钟	想（响）得多
庙堂里失盗	神不知鬼不觉
庙堂里算命	疑神疑鬼
庙小菩萨大	盛不下
乜（mie）斜眼打麻将	观点不正
灭灯打婆娘	暗里下手
灭灯念鼓词	瞎说
灭火踢倒油罐子	火烧火燎；火上加油
灭虱子烧皮袄	因小失大
灭烛看家书	公私分明
篾匠的货	自己编的
篾匠赶场担一担	前后为难（篮）
篾条穿豆腐	没法提；提不得；别提了；提不起来
篾条捆竹子	自家人整自家人
名牌货便宜卖	物美价廉
名牌牙刷	一毛不拔
名医开处方	对症下药
明鼓对明锣	明打明
摸到好牌不吱声	暗算；暗喜
摸到泥鳅当鳝鱼	不知长短
摸黑吃桃子	拣软的捏
摸黑儿打耗子	到处碰壁
摸石头过河	稳稳当当；摸索着干
摸着光头乐	耍滑头
摸着石头过河	稳稳当当
摸着胸口拿钥匙	寻开心
馍馍掉粪坑	臭货；肮脏货
模板里的水泥	定了型；定型了
模范找英雄	一对红
摩天楼上说天书	高谈阔论
磨刀水洗头	脑筋生锈
磨道的驴子	听喝的；走不出圈套
磨道放屁	臭一圈
磨道里的驴子断了套	空转一遭
磨道里等驴	没跑；跑不了
磨道里找蹄印	步步有点；有的是
磨道里走路	没头没尾；没尽头
磨剪刀的说梦话	快了
磨扇里的窟窿	有眼无珠
磨上睡觉	转向了
磨眼里的蚂蚁	条条是路；条条是道
磨眼里推稀饭	装糊涂’
磨子上睡觉	转了向；想转了
磨子撞碓窝（dui wo石臼）	实（石）打实（石）
魔鬼找妖怪	坏到一块了
魔术师变戏法	无中生有
魔术师的本领	弄虚作假
魔术师的帕子	无中生有
魔术师放烟雾弹	遮人眼目
魔术师演戏	变化多端
抹布盖牛背	露头角（脚）
抹黑脸照镜子	自己吓唬自己；自找难看
抹上唾沫当眼泪	假慈悲；假慈善
抹桌布擦脸	不利索
抹桌布做衣裳	不是这块料
抹桌子的布	专拣脏活干
茉莉花喂骆驼	无济于事；不济事
茉莉花喂牲口	不上算；不合算
陌路相逢谈恋爱	一见钟情
墨斗鱼的肚子	黑心肝；心肠黑
墨里藏针	难找寻
墨鱼肚肠河豚肝	又黑又毒
墨汁里加石灰	瞎搀和；乱搀和
墨汁煮元宵	漆黑一团；一团漆黑
母鸡长牙齿	不可能的事；没人见过；没有的事
母鸡吃烂豆子	一肚子坏点子
母鸡带小鸡	寸步不离
母鸡带崽	各顾各（咯咕咯）
母鸡掉在米箩里	求之不得
母鸡跌米缸	饱餐一顿
母鸡丢蛋出告示	小题大做
母鸡孵小鸭	多管闲事
母老虎，地头蛇	惹不起
母老虎骂街	没人敢惹
母猫吃小崽	自残骨肉
母夜叉骂街	谁也不敢碰
母猪不吃糠	反常
母猪嘲笑马脸长	不自量
母猪吵架	笨嘴拙舌
母猪打架	嘴上功夫
母猪掉进泔水缸	饱餐一顿
母猪耳朵	耳朵软；软骨头
母猪怀狗崽	怪胎
母猪遛（liu）土豆	全凭一张嘴；全仗嘴
母猪钻进玉茭（玉米）地	寻着吃棒子（玉米）
木板上的钉子	一动也不动
木槌敲金钟	配不上；不配
木耳烧豆腐	黑白分明
木杆子撑排	通到底
木夹里的油枯（油饼）	上挤下压
木匠挨板子	自作自受
木匠打老婆	有尺寸
木匠戴枷板	自作自受；自作孽
木匠的斧子	一面砍
木匠的锯子	嘴巴子尖；嘴巴子厉害
木匠的凿子铁匠的锤，裁缝的皮尺厨子（厨师）的刀	各有一套
木匠的折尺	能屈能伸
木匠吊线	睁只眼，闭只眼；正直
木匠丢了墨线	全凭眼力
木匠丢了折尺	没有分寸
木匠拉大锯	有来有去；拉拉扯扯
木匠师傅吵嘴	争长论短
木匠师傅夺斧子	砸人饭碗
木匠师傅劈柴	不在话下
木匠推刨子	抱（刨）打不平；专管不平事；直来直去
木匠摇墨斗	连轴转
木匠做家具	有尺寸；心中有数；肚里有数
木刻的苦罗汉	难得一笑
木框里的算盘珠子	由人摆布；任人摆布
木棉开花	越开越红
木脑壳（木偶）唱潘仁美（《杨家将》中的奸臣）	人托人害人
木脑壳唱戏	装模作样；装样子
木脑壳流眼泪	假仁假义；虚情假意
木脑壳跳舞	幕后操纵
木偶不叫木偶	傀儡
木偶的服装	另搞一套
木偶进当铺	拿你不当人
木偶上戏台	幕后有人
木偶生疮	无关痛痒；不痛不痒
木偶谈恋爱	呆头呆脑
木偶跳得欢	靠的牵线人；总有牵线人
木偶跳塘	不成（沉）
木偶戏表演	装腔作势；任人摆布
木偶下海	摸不着底
木偶做戏	受人牵连
木排过险滩	顺流而下
木排上跑马	蹩脚
木排上捎信	靠不住；不可靠
木器店里的棺材	目（木）中无人
木勺炒豆子	同归于尽
木炭搭桥	难过
木桶淘米	水泄不通
木头耳朵	说不通
木头鸡儿	呆头呆脑
木头人过河	不成（沉）
木头人救人	自身难保
木头人坐轿子	不识抬举
木头上钉钉子	个个有钻劲
木头眼镜	看不透
木头支歪墙	硬顶
木鱼改梆子	将就材料；还是挨敲的货
木鱼张嘴	等着挨敲
牧人不刮胡子	溜（留）须拍马
穆桂英出征	马到成功
穆桂英挂帅	威风凛凛
穆桂英和杨宗保	恰好一对
穆桂英破洪州	马到成功
拿菜刀哄孩子	不是闹着玩的
拿钞票揩屁股	胡作非为
拿大顶（用手撑地倒立）看世界	一切颠倒
拿刀子逗小孩	不是玩艺儿
拿豆腐挡刀	招架不住（比喻支撑不了。）
拿豆腐去垫台脚	不顶事儿
拿个小钱当月亮	吝啬鬼
拿根高粱秆当扁担	挑不起重担；难挑担
拿根麦芒当棒槌	小题大做
拿根面条去上吊	死不了人
拿狗屎当麻花	香臭不分
拿瓜当脑袋剃	昏头昏脑；昏了头
拿锅盖戴头上	乱扣帽子
拿鸡毛当令箭	轻举妄动
拿金条塞墙缝	大材小用
拿癞蛤蟆哄孩子	不是东西
拿了秤杆忘秤砣	不知轻重
拿芦杆当顶梁柱	难撑
拿尿盆当帽子	走到哪臭到哪；走一路臭一路
拿尿盆往头上扣	自找没趣
拿破仑上台	野心勃勃；野心太大
拿乌龟壳当锅盖	捂不住
拿五马倒六羊	赂了个头朝下
拿鞋当帽子	上下不分
拿针眼当烟筒	小气
拿住荷杆摸到藉	抓根本
拿着棒槌当针纫（ren引线穿过针鼻儿）	一点心眼也没有；缺少心眼
拿着棒槌缝衣服	啥也当真（针）
拿着草帽当锅盖	乱扣帽子
拿着车票进戏馆子	不对号；对不上号
拿着钝刀抹脖子	杀不死也痛
拿着蜂房变戏法	耍心眼
拿着凤凰当鸡卖	贵贱不分
拿着擀面仗当箫吹	实心没眼儿
拿着棍子叫狗	越叫越远
拿着孩子当熊耍	愚弄人
拿着耗子当成牛	吹的
拿着和尚当秃子打	冤枉好人（比喻没有事实根据，给人加上罪名。）
拿着虎皮当衣裳	吓唬人
拿着黄莲当箫吹	苦中取乐
拿着活人当熊耍	愚弄人
拿着鸡蛋走冰路	小心翼翼
拿着鸡蛋走滑路	小心翼翼
拿着鸡毛当令箭	小题大作（比喻把小事当成大事来处理。）
拿着门扇当窗户	门户不对
拿着面盆当月亮	不知轻重
拿着碾盘打月亮	不知轻重
拿着蒲扇生炉子	煽风点火
拿着扫帚上杏树	扫杏（兴）
拿着手镯敲铜锣	一手拿金，一手抓银
拿着算盘串门	找仗（帐）打
拿着铁锹当锅使	穷极了
拿着鞋子当帽子	上下不分
拿着野鸡做供品	家财难言
拿着钥匙满街跑	有职无权；当家不做主
哪壶不开单提哪壶	没眼力
哪吒发火	耍孩子脾气
哪吒闹海	惊天动地
纳鞋底不拴线结	前功尽弃
纳鞋底戳了手	真（针）气人
奶妈抱孩子	人家的
奶妈怀里的娃娃	人家的
奶奶的鞋子	老样子
奶牛的咂儿头（za er tou奶头）	受人排挤
奶娃娃张口	光等吃
奈何不得冬瓜，只把茄子磨	欺软怕硬
囡囡（nan nan对小孩儿的昵称）看杂技	又爱又怕
男儿的田边，女儿的鞋边	好看
南北大道	不成东西
南瓜菜就窝头	两受屈
南瓜长在瓦盆里	没出息
南瓜炒鸡蛋	一色货；一样的货色
南瓜地里栽山芋	扯来扯去
南瓜地里种豆角儿	绕过来扯过去
南瓜蔓上结芝麻	越小越香
南瓜苗掐尖	光出岔子；净岔子
南瓜命	越老越甜
南瓜秧攀葫芦	纠缠不清
南瓜叶揩屁股	两面不讨好
南郭先生吹竽	滥竽充数；不懂装懂
南极寿星，太上老君	各有千秋
南极仙翁的脑袋	宝贝疙瘩
南京路上的霓虹灯	五光十色；光彩夺目
南来的燕，北来的风	挡不住
南泥湾开荒	自给自足
南墙根儿的茄子	阴蛋（比喻不露面的坏东西。）
南山的豹，北海的蛟	凶的凶，狠的狠
南山的毛竹	节节空
南山滚石头	实（石）打实（石）
南山上的松柏	四季常青
南天门踩高跷	高高在上
南天门的旗杆	光棍一条
南天门的土地	管得宽
南天门挂灯笼	高明；四方有名（明）；高照
南天门敲鼓	名（呜）声远扬；远近闻名（鸣）
南天门上长大树	顶天立地
南天门上唱戏	没声没影
南天门上搭戏台	唱高调
南天门上打伞	一跳邪气
南天门上的玉柱	光杆儿
南天门上放哨	警惕性高
南天门上热爱窟窿	塌天大祸
南天门上演说	高调
南天门上种南瓜	难（南）上加难（南）
南天门种南瓜	难上难（南上南）
南天门作揖	高情（擎）难（南）领（岭）（比喻十分感激。）
楠木做马桶	用材不当
�Q鼻子（nang bi zi说话时鼻音特别重的人）吃肉	一窍不通
挠出来的疮	自讨麻烦
脑袋成了葫芦	头昏脑涨
脑袋掉了不过碗口大的疤	视死如归
脑袋顶上推小车	走投（头）无路
脑袋瓜儿长秃疮	不是好剃的头；刺儿头
脑袋进了拍卖行	要钱不要命
脑袋上插烟卷	缺德带冒烟儿
脑袋上长疮，脚底板流脓	坏透了
脑袋上长角	出格；大难临头
脑袋上戴犁头	又奸（尖）又猾（滑）
脑袋上的蚂蚁	头头是道
脑袋上顶锅巴	犯（饭）人
脑袋上放钥匙	开头难
脑袋上冒烟	火气上头
脑袋上生疮	头痛；坏到顶了
脑袋上刷浆糊	糊涂到顶
脑袋上套袜子	放不下脸；脸面上不下来；能出脚来了
脑袋系在裤带上	不要命；豁出来了（比喻丢了性命也在所不惜。）
脑袋陷进泥塘里	糊涂到顶了
脑瓜上套袜子	能出角（脚）了
脑浆子撤地	一塌糊涂
脑壳捣大蒜	扎扎实实
脑壳顶扁担	头挑
脑壳上安电扇	出风头
脑壳上安风扇	大出风头
脑壳上搽猪油	滑头；滑头滑脑
脑壳上穿袜子	不是角（脚）
脑壳上戴碓窝（dui wo石臼）	不知轻重
脑壳上顶锅	乱扣帽子
脑壳上顶门板	好大的牌子
脑壳上顶娃娃	举人；抬举人
脑壳上顶西瓜	滑头对滑头
脑门上长瘤子	额外负担；突出
脑门上长眼睛	跟朝上；眼向上看
脑门上钉门扳	好大牌子
脑门上放鞭炮	大难临头；灾祸临头；惊心动魄
脑门上挂灯笼	惟我高明
脑门上挂算盘	算的眼前
脑门上挂钥匙	开眼界
脑门上开口	对天讲话
脑门上抹黄连	苦到头了
脑门上抹糨子（jiang zi 糨糊）	糊涂到底了
脑门上贴邮票	走人了
脑门上写字	明摆着
脑门上着火	急在眼前
脑门生疖子	额外负担
脑勺子后长疙瘩	看不见自己的缺点
闹市里盖公厕	方便大家
闹市里开店铺	有利可图
闹市区做生意	买卖兴隆
闹钟打哈哈	自鸣得意，
嫩苗苗	根底浅
嫩竹扁担	挑不起重担；难挑担
嫩竹扁担挑瓦罐	担风险
嫩竹扁担挑重担	自不量力；吃不住劲
嫩竹拱土	冒尖
嫩竹子做扁担	挑不了重担
能干他娘哭半夜	能干死了
能字添四点	熊样
尼姑庵里借梳子	办不到；没法办
尼姑的脚	难缠
尼姑的木梳	多余
尼姑瞧嫁妆	白欢喜；空喜一场
尼姑生孩子	暗中行事；不敢让人知；要也不是，不要也不是
尼姑偷汉	躲躲闪闪
尼姑头上插花	没法（发）
尼姑下山	心野了
尼姑养儿子	岂有此理
尼姑有喜	不好处理；不可告人
尼姑只剃半边头	不诚心
泥巴匠砌砖	后来居上
泥巴捏的小子	没骨气
泥巴土地下水	自身难保
泥巴团扔到江里	泡着吧
泥地上跑马	一步一个脚印
泥地上摔豆腐	稀烂
泥佛劝土佛	同病相怜
泥佛爷的眼珠儿	动不得
泥匠送礼	拿不出手
泥捏的佛像	实心眼；没心肝；没安人心
泥捏的老虎	样子凶
泥捏的勇士	上不了阵势
泥牛人海	无消息；杳无音信；有去无回
泥菩萨摆渡	难过
泥菩萨打架	散了
泥菩萨的肚腹	实心实肠
泥菩萨掉在汤锅里	浑身酥软
泥菩萨渡海	没人（神）保
泥菩萨过河	自身难保
泥菩萨过江	自身难保
泥菩萨救火	无动于衷
泥菩萨擂流	难过
泥菩萨伸手	死活都要钱
泥菩萨身上长了草	慌（荒）了神（比喻心慌意乱，。）
泥菩萨摔跤	散架了
泥菩萨洗脸	失（湿）面子；越洗越难看
泥菩萨遭雷打	粉身碎骨
泥菩萨坐公堂	死官僚
泥鳅吃了石灰水	死硬（比喻呆板、不灵活。或指顽固。）
泥鳅打鼓	乱谈（弹）
泥鳅跌进碓窝（dui wo石臼）里	没处钻了
泥鳅跌汤锅	看你往哪钻
泥鳅过鱼网	无孔不入
泥鳅黄鳝交朋友	滑头对滑头
泥鳅落旱田	干蹦干跳
泥鳅上沙滩	不怕你滑
泥鳅跳龙门	痴心妄想；妄想
泥鳅钻到猫窝里	看你怎么耍滑头
泥人吃饼子	难言（咽）
泥人吃饺子	难言（咽）
泥人戴纸帽	经不起风吹雨打
泥人的肚腹	毫无心肝
泥人的脸	面如土色
泥人儿掉在河里	没人样了（比喻造得很狼狈。）
泥人经不起风雨	本质太差
泥人人海	有去无回
泥人遇木偶	面面相觑（qu看；瞧）
泥沙俱下	难分难解
泥水沟里游泳	施展不开
泥水匠拜佛	自己心里明白；自家知底细
泥水匠的瓦刀	光图表面
泥水匠无灰	专（砖）等
泥水匠招手	要你（泥）；要吐（土）
泥水塘里洗萝卜	拖泥带水
泥潭里滚石头	越陷越深
泥娃娃的脑壳	七窍不通
泥娃娃的嘴	总是笑呵呵的
泥娃娃跳黄河	洗不清；洗不净
泥娃娃遭雨林	软瘫了；软作一堆
泥娃娃遭雨淋	软瘫了
泥瓦匠出身	和稀泥
泥瓦匠干活	拖泥带水
泥瓦匠砌墙	两面三刀
泥瓦匠收拾家什	不干了
泥蒸的馒头	土腥味
泥做的菩萨	全靠贴金
你吃鸡鸭肉，我啃窝窝头	各人享各人福
你吹喇叭我吹号	各吹各的调
你打我一拳我踢你一脚	谁也不让谁
你给我个初一，我给你个十五	互不相让；谁也不让谁
你卖门神我卖鬼	同行
你去南极我去北极	各走一端
你有秤杆我有砣	配得起你
你有骏马我有金鞍	配得起你
你走你的阳关道，我走我的独木桥	互不相干；各不相干
你做生意我教书	人各有志
逆风放火	引火烧身
逆水驾木筏子	不进则退
逆水行舟	顶风顶浪
溺（ni）死鬼找替代	拉人落水
年糕掉进石灰坑	难收拾；不可收拾
年过花甲不成才	虚度年华；枉活了大半辈子
年过花甲得子	老来喜
年画上的春牛	离（犁）不得
年画上的鱼	中看不中吃
年近古稀嗅觉低	老鼻子啦
年轻人扛大梁	后生可畏
年轻娃娃扛碌碡（liu zhou石磙）	正在劲头上
年三十的案板	借不得；不得空
年三十晒衣裳	今年不干明年干
年三十讨口	丢人现眼
年三十夜拨算盘	满打满算
年三十夜的年糕	人有我有；你有我也有
鲇鱼打喷嚏（pen ti）	自我吹嘘（须）
鲇鱼找鲇鱼，王八找王八	物以类聚
撵（nian驱逐）走狐狸住上狼	一个比一个恶；一个更比一个凶
撵（nian追赶）汽车拾粪	白跑；不看对象
撵走孤狸住上狼	一伙更比一伙凶（比喻一个比一个凶狠。）
碾盘碰磨扇	实（石）打实（石）
碾上打盹	想转了
碾砣子雕神像	实（石）心眼
碾子磨	实（石）对实（石）（比喻两个人做事都非常实在。）
念九九表	说话算数
念完了经打和尚	恩将仇报；以怨报德；没良心；有用是亲，无用是仇（比喻翻脸不认人。）
娘不正经	热（爹）多
娘儿俩嫁人	各有一喜
娘家门上的人	格外亲
娘俩做媳妇	各人忙各人
娘娘庙里求子	有求必应
娘娘养侄女	两耽搁
娘胎里长胡子	未老先衰
娘胎里带来的	更改不了；改不了；变不了
鸟铳（niao chonq一种打鸟用的旧式火器）轰蚊子	派错了用场
鸟儿搬家	远走高飞
鸟过拉弓	错过时机
鸟见树不落	要飞了
鸟类吃食	不得不低头
鸟枪打兔子	睁只眼，闭只眼
鸟枪换炮	越变越好；越来越好；越来越神气
鸟字写成乌	还差一点
尿鳖子（夜壶）盛酒	不是正经东西；满不在乎（壶）
尿鳖子打酒	满不在乎（壶）
尿鳖子漏底	下流
尿鳖子镶金边	臭讲究
尿壶掉井里	吞吞吐吐
尿壶镀金箔	外面光，里面脏；外头好看里面臭
尿壶里打酒	错了
尿壶没底	下流
尿壶烫酒	不是正经家伙；不是个家伙
尿盆里炒鸡蛋	不对味；不是味儿
尿盆里洒香水	臊气还在
尿盆里栽牡丹	底子臭；根子不净
捏鼻子吃葱	忍气吞声（生）
捏鼻子吹螺号	忍气吞声
捏鼻子捂嘴巴	不闻不问
捏死手中鸟	轻而易举
捏住鼻子过日子	不闻香臭
捏住鼻子喝木哩	一声儿不响
捏着鼻尖儿做梦	不成
捏着鼻子唱戏	闷腔
捏着鼻子吃葱	忍气吞声（生）
捏着鼻子过日子	不知香臭；闻不着香臭
捏着鼻子哄眼睛	自欺欺人；自骗自；自己哄自己
捏着拳头过日子	心里憋气
捏着眼皮擤（xing）鼻涕	劲用得不是地方
捏着一分钱能攥出汗来	会过日子
牛背上翻跟头	有点硬功夫
牛背上放马鞍	乱套了
牛鼻里爬小蟹	大惊小怪
牛鼻绳落人手	身不由己；不由自主
牛鼻子插大葱	装相（象）
牛鼻子穿环	让人牵着鼻子走
牛鼻子上的跳蚤	自高自大
牛鞭（牛阴）敬神	神也得罪了，人也得罪了
牛踩乌龟背	心里痛；痛在心上
牛长鳞，马长角	不可能的事；没人见过
牛吃苞米（玉米）秸	天生的粗料
牛吃草来狗吃屎	各有各的口味；各对口味
牛吃草料鸭吃谷	各人有各人的福；各人享各人福
牛吃赶车人	无法无天
牛吃破草帽	一肚子坏圈圈
牛吃桑叶	结不成什么茧；结不成啥茧
牛吃笋子	胸有成竹
牛鼎倒个儿	大翻身
牛鼎烹鸡	大材小用
牛犊捕家雀	心灵身子笨
牛犊拉车	乱套
牛犊子叫街	懵（meng懵懂；不清楚）门了
牛犊子拉车	乱了套；拽（zhuai拉）不动；强挣扎
牛犊子拉犁耙	不打不走；不在行
牛犊子扑蝴蝶	看着容易做着难
牛犊子撒娇	顶顶撞撞；又顶又撞
牛犊子上套	挨鞭子的日子到了
牛犊子学耕田	上了圈套；让人牵着鼻子走
牛犊子学拉犁	让人牵着鼻子走
牛粪堆上的蘑菇	好看不好吃
牛粪上插花	底子臭；根子不净
牛给羊抵头	仗着脸上
牛耕田，马吃谷	一个受累，一个享福
牛骨头煮胶	难熬
牛角安在驴头上	四不像
牛角对菱角	一对奸（尖）
牛角挂稻草	轻巧
牛角尖对牛角尖	对奸（尖）
牛角里栽花	根骨不正
牛龛里的虫	硬钻（比喻硬往里挤）
牛拉碌碡（liu zhou石磙）	打圆场
牛拉磨子	走不出圈套
牛拉碾子	上了圈套
牛拉汽车	怪事一桩
牛栏里关猪	不可靠；来去自由
牛栏里伸进张马嘴	没你开口的份儿
牛郎会织女	喜相逢
牛郎配织女	天生一对
牛郎约织女	后会有期
牛郎织女哭梁祝	同病相怜
牛郎织女相会	一年一次
牛毛上解锯	刻薄
牛毛羊毛和驴毛	全是痞（皮）子出身
牛魔王的兵	千奇百怪
牛奶拌墨汁	黑白不分；混淆黑白
牛奶里掺墨汁	黑白混淆
牛棚里养鸡	架子不小；好大的架子
牛皮袄子反穿	逗虱子走穹路
牛皮灯笼	心里亮；照里不照外
牛皮饭碗	打不破
牛皮鼓	声大肚子空
牛皮鼓，青铜锣	不打不响
牛皮鼓湿水	不响
牛皮糊窗户	不透风
牛皮纸糊的鼓	不堪一击；经不起敲打
牛皮纸上雕花	刻薄
牛屁股后的苍蝇	一哄而散；盯（叮）上不放
牛屁股后面打灯笼	不起作用
牛屁股后面念祭文	说空话
牛屁股后念祭文	白费口舌
牛牵鼻子马抓鬃	抓住了关键
牛群回山寨	前呼后拥
牛身上拔根毛	不在乎；无伤大体；无关大体
牛身上的毛	数不清
牛身上爬蚂蚁	不显眼
牛瘦骨不瘦	底子好
牛死日也落	祸不单行
牛踏臭冬瓜	浑身冒坏水
牛套马	累死俩
牛蹄子两瓣	合不拢
牛蹄子上供	就显你角（脚）大
牛驮子搁在羊背上	担当不起
牛王爷不管驴的事	各管各的
牛尾巴	两边摇摆
牛尾巴拍苍蝇	凑巧了；赶得巧；正好
牛尾打牛身	不痛
牛眼看人	高瞧了你
牛羊的肚腹	草包
牛羊人圈鸟落窝	各得其所
牛蝇叮牛蹄	无关痛痒；不痛不痒
牛嘴上套篾篓	口难开；不好开口
扭着脖子想问题	尽是歪道理
农村的老黄牛	苦了一辈子
脓胞破了顶	烂透了
弄堂里扛木头	直来直去；直进直出
女大十八变	越变越好看
女儿拜寄娘	亲上加亲
女儿穿娘的鞋	老样子
女儿国办婚事	难得有一回
女儿国招附马	一厢情愿
女驸马进洞房	一个喜来一个忧；喜的喜，忧的忧
女驸马招亲	不明真相
女鬼偷汉	死不要脸
女孩子打架	抓小辫子
女人的手腕	没多大劲
女人扎鞋底	千真（针）万真（针）
女娃娃缝尿布	虑事太宽
女婿认不得丈人	有眼不识泰山
女子走钢丝	胆大心细
暖房里的菜畦	四季常青
暖房里做冰棒	冷热结合
暖壶瓶里装星图	胆大包天
暖酒不喝喝卤水	送死；寻死；自己打死
暖水瓶的塞子	赌（堵）气
暖水瓶里装开水	外冷里热；外边冷，里面热
糯米粑粑掉地上	难收拾；不可收拾
糯米粑粑	软货
糯米饭搓粑粑	扯也扯不开
糯米粉就糍粑（ci ba）	粘上了
糯米换地瓜	不上算；不合算
糯米团滚芝麻	多少沾点
偶像面前磕头	毕恭毕敬
藕炒豆芽	内外勾结
藕炒黄豆	无孔不入
藕炒韭菜	清清（青青）白白
藕断丝不断	离不得;离不开
藕粉煮糍粑（ci ba）	糊糊涂涂；糊里糊涂
藕丝炒豆芽	勾勾搭搭
藕丝炒黄豆芽	勾勾搭搭
藕眼里的泥	洗不干清；洗不干净
沤烂的花生	不是好人（仁）
趴在磨子上睡觉	想转了
爬竿比赛	看谁上得快
爬高梯摘月亮	空想
爬楼梯跌跤	爬得越高摔得越重
爬山虎的本领	会巴结
爬上马背想飞天	好高鹜远
爬上山顶打铜锣	站得高，想（响）得远
爬上山顶纳凉	走上风；尽走上风
爬上塔顶吹笛子	高调
爬上屋脊的螃蟹	横行到顶了
怕死碰见鬼子兵	在劫难逃
怕死碰见送葬的	倒霉透了；真倒霉
拍大腿吓老虎	一点没用
拍马屁的拍上了大腿	错上加错
拍马屁拍到马嘴上	倒咬一口
拍马屁拍到蹄子上	倒挨一脚
拍拍屁股就走	不管了
拍一下肩膀屁股痛	浑身是病
拍一下脑壳脚底动	灵透了
排笔绘画	线条太粗
排队梳辫子	一个一个来
排骨抛饿狗	有去无回
排骨烧豆腐	有硬有软
牌楼下躲雨	暂避一时
潘金莲熬药	暗中放毒
潘金莲的裹脚布	臭货；肮脏货
潘金莲的信条	宁在花下死，做鬼也风流
潘金莲给武松敬酒	别有用心
潘金莲敬酒	丑话说在前
潘金莲上庵堂	假正经；假装正经
潘金莲偷汉子	本性难移
潘仁美挂帅	奸臣当道
潘仁美会严嵩	一对奸臣
盘古（我国神话中的开天辟地的人物）的斧头	开天辟（劈）地
盘古王耍板斧	老当益壮
盘古王耍拨浪鼓	老天真
盘山公路上开车	弯弯绕
盘子里生豆芽	根底浅
判官办案	吓死人
判官错点生死簿	糊涂鬼
判官的女儿	鬼丫头
判官跌跤子	冒失鬼
判官拍照	鬼样子；鬼相
判官敲门	催命鬼
判官娶媳妇	鬼打扮
判官讨饭	穷鬼
判官头上抹糨子（jiang zi糨糊）	糊涂鬼
判官玩魔术	鬼把戏
判官演魔术	尽耍鬼把戏
判决书做衣裳	浑身是罪
盼望长空裂大缝	异想天开
盼望出太阳的姑娘	想情（晴）人
盼望月亮从西出	没指望
螃蟹穿在柳条上	难分难解
螃蟹的脚杆	弯弯多
螃蟹的眼睛	死不瞑目
螃蟹洞里打架	窝里横
螃蟹断了爪	横行不了几天
螃蟹过河	七手八脚
螃蟹过街	横行霸道
螃蟹夹鸡蛋	滚的滚，爬的爬；连滚带爬；滚蛋
螃蟹教子	不走正道
螃蟹进了鱼篓子	有进无出
螃蟹拉车	不走正道；光走歪道
螃蟹满地爬	到处横行
螃蟹爬到当路上	横行霸道
螃蟹娶亲	尽是王八
螃蟹上吊	悬空八只脚
螃蟹上树	巴不得
螃蟹生鳞鱼生脚	怪事一桩；怪事
螃蟹吐沫	没完没了
螃蟹吐唾沫	没完没了
螃蟹造反	横冲直撞
胖大海掉进黄莲水	苦水里泡大的
胖老婆骑瘦驴	肥瘦相搭
胖婆娘过窄门	门当（挡）户对
胖嫂骑瘦驴	配不上；不配
胖子排横队	齐头并进
抛了锚的汽车	寸步难行
抛球招亲	未必如意
炮打老帅	将了军
炮打林中鸟	一哄（轰）而散
炮弹打在炮筒里	巧得很；巧极了
炮弹进炮膛	直来直去；直出直人
炮台上的麻雀	吓破了胆
炮筒里的炮弹	一触即发
炮筒里装针	细心；心细
炮仗（爆竹）捻的脾气	一点就着；点火就着
炮仗炸碾盘	稳而不动
袍子改袄	越来越小
袍子改汗衫	有余
跑步比赛	你追我赶
跑了耗子捉狐狸	一个比一个刁
跑了虾公捉到鲤鱼	理更好
跑了虾子捉到鲤鱼	格外好
跑了羊修圈	防备后来（比喻在事情失败之后，想办法去补救。）
跑马吃烤鸭	这把骨头不知往哪扔
跑马使绊子	存心害人
泡泡糖粘住糯米饭	扯也扯不开
泡软的豆子	不干脆
泡软了的豆子	不干脆
泡桐树锯菜板	心虚
泡透的土墙	难长久
喷火器的脾气	张口就发火
盆子里摆鸡蛋	可数的几个
盆子里摆山水	假景
嘭嘭响的西瓜	熟透了
彭祖遇寿星	各有千秋
膨胀的皮球	一肚子气
捧土加泰山	不起作用
捧着金碗当乞丐	何必求人；高兴得发傻
捧着金碗讨饭	何必求人
捧着金碗要饭吃	装穷叫苦
捧着泥鳅玩	耍滑头
捧着书本骑驴	走着瞧
捧着鲜花坐飞机	美上天了
碰到南墙不回头	死心眼
披大氅（chang大衣）偷烟袋	文明人不做文明事
披虎皮上山	吓唬人
披麻袋上朝	难登大雅之堂
披麻救火	引火烧身
披蓑衣的被狗咬	穷人好欺负
披蓑衣救火	惹火烧身；惹火上身
披蓑衣救人	惹火（祸）上身（比匕喻自己招来祸害。）
披蓑衣上朝	献丑；自己献丑
披蓑衣钻篱笆	东拉西扯；勾勾搭搭
披西装穿草鞋	不相称
披着虎皮进村	吓唬老百姓
披着破被子上朝	穷尽忠
披着蓑衣啃红薯	穿没穿啥，吃没吃啥
砒霜里浸辣椒	毒辣透顶
劈开房梁做火把	大材小用
皮包商做生意	沾手三分肥
皮坊的老板	牛皮大王
皮匠不带锥子	真（针）好
皮裤套棉裤	必定有缘故
皮裤套皮裤	定有缘故
皮箩里洗虾公	一个也跑不了
皮球擦油	又圆又滑
皮球打蜡	又圆又滑
皮球掉进面茶里	说他混蛋，他还一肚子气
皮球掉在油缸里	又圆又滑
皮球落水	浮在表面
皮球上戳了一刀	泄了气
皮球上磨刀	泄气
皮软骨头硬	表面和气
皮条打人	该收拾
皮娃娃砸狗	把你不当人
皮鞋打蜡	一时光
屁股长疮脚扎刺	坐立不安
屁股底下安弹簧	一蹦老高
屁股里夹扫帚	伟（尾）大
屁股上插针	越隐越深
屁股上长疮	阴毒；离心远着哪
屁股上打花脸	哪有人样
屁股上吊棒槌	自家人打自家人；自打自
屁股上吊蒲扇	走上风；尽走上风
屁股上吊扫帚	好伟（尾）大
屁股上挂粪筐	等死（屎）
屁股上画眉眼	好大的面子
屁股上锯锯子	截断后路
屁股上抹香水	不值一文（闻）
屁股上拴石头	累赘
屁股上捅一刀	背后整人
屁股上扎蒺藜（ji li 一年生草本植物。果皮有尖刺）	坐不稳；坐不住
屁股生疮背又痛	坐卧不安；坐卧不宁
屁股坐在别人的脑袋上	欺人太甚；太欺负人
屁股坐在鸡蛋上	一塌糊涂
屁股坐竹凳	底子空
乒乓球打七板子	推三阻四
平坝头躲壮丁	无地容身；无地藏身
平地不走爬大坡	自讨苦吃；自找罪受
平地搭梯子	无依无靠
平地的骡子	不懂坎儿
平地里起坟堆	无中生有
平房门前不漏雨	有言（檐）在先
平民百姓见玉帝	一步登天
苹果掉在箩筐里	乐（落）在其中
屏风上贴门神	话（画）中有话
屏风上贴仕女图	话（画）里有话（画）
瓶口封蜡	滴水不漏
瓶子里的苍蝇	没有出路
瓶子盛糨子（jiang zi 糨糊）	装糊涂
泼妇打架	劝不得
泼妇骂街	不像话；耍无赖；不讲道理
泼在地上的水	难收拾；不可收拾
婆婆穿花袄	老来俏
婆婆穿花鞋	赶时兴；赶时髦
婆婆给爹爹做鞋	老样子
婆婆一个说了算	没公理
婆婆嘴吃西瓜	滴水不漏
婆媳吵架儿子劝	左右为难
婆媳两个双守寡	没工（公）夫
笸箩（po luo盛谷物等的器具。用柳条或篾条等编成）里睡觉	卑躬（背弓）屈膝
迫击炮打斑鸠	大材小用
迫击炮打蚊子	小题大做
迫击炮对机关枪	半晌回一句
迫击炮装手榴弹	不对口径
破鞍子对瘦驴	穷凑合；穷凑
破包子	露了馅
破被子裹元宝	好的在里面
破表	没准儿
破草帽	无边无沿
破茶壶掉进水里	几头进水
破船过江	人人自危
破大褂	没理（里）
破堤的洪水	来势凶猛
破鼓配上破锣	穷作乐；穷快活
破拐杖	靠不住
破罐子	甩了
破夹袄上绣牡丹	只图表面好看
破饺子	溜边了
破空竹	抖不起来；不想（响）
破喇叭	吹不响
破凉伞	好骨子
破梁做根烧火棍	大材小用
破笼屉	不成（盛）气
破锣嗓子唱山歌	不入调；不入耳
破锣嗓子	没好声
破麻袋装宝	有内才（财）
破麻袋装着烂套子	不是好货
破麻袋做裙子	不是这块料
破马蹄表	没准儿
破棉袄	里外孬（nao 坏；不好）；里外都不好
破棉袄套绸衫	装面子
破庙里的菩萨	东倒西歪
破皮球，烂轮胎	到处泄气
破皮球缝帽子	不成器（盛气）
破琵琶	不好谈（弹）
破筛子贴膏药	千孔百疮
破铜烂铁当武器	打烂仗
破土的春笋	拔尖
破袜子补帽沿	一步（布）登天
破网打鱼	瞎张罗
破网捞虾	落空
破屋门	老得用棍儿顶着
破蒸笼蒸馒头	浑身是气；气不打一处来
剖肚腹翻肠子	丢（抖）丑（臭）
剖腹藏珍珠	爱财不爱命
剖腹献肝胆	死尽忠心
剖开墨鱼肚	一付黑心肠
剖鱼得珠	格外珍贵；喜出望外
菩萨的长虫	佛口蛇心
菩萨的胡须	人造的
菩萨的胡子	人安的
菩萨的心肠	软的
菩萨掉大河里	留（流）神
菩萨掉到染缸里	贪色鬼
菩萨跺脚	妙（庙）极（急）了
菩萨屁股底下长草	慌（荒）了神
菩萨扫地	劳神
菩萨头上拉屎	糟踏神像
菩萨头上冒烟	好神气
菩萨吞长虫（蛇）	佛口蛇心
菩萨坐冷庙	孤苦怜订
葡萄汁充花露水	不是那块香料
蒲扇打锣	面面俱到
蒲扇两边摇	两面讨好；两头落好
七八月的南瓜	皮老心不老（比喻人虽老了，但上进心还很强。）
七尺缸里打飞脚	处处碰壁
七尺汉子六尺门	不得不低头
七个矮人睡一头	低三下四
七个婆婆拉家常	说三道四
七个钱放两处	不三不四
七个人聚会	三朋四友
七个人睡两头	颠三倒四
七个人通阴沟	低三下四
七个仙女争面脂	香三臭四
七根扁担丢一旁	横三竖四
七根笛子一起吹	一个音
七姑八舅抬食盒	彬彬（宾宾）有礼
七斤面粉调了三斤糨糊	尽办糊涂事
七棵树栽两行	不三不四
七里渡船喊得来	全凭一张嘴；全仗嘴
七里岗放风筝	由它去；随它去
七两放在半斤上	只差一点；差一点
七面锣八面鼓	七想（响）八想（响）
七窍通六窍	一窍不通
七擒孟获	叫他口服心服
七十老汉演花旦	别出心裁
七十老汉坐摇篮	老天真
七十老翁叼九十斤重的旱烟袋	全凭嘴劲；嘴巴子劲
七十岁婆婆学绣花	老来发奋
七十岁讨老婆	老来喜
七十岁学气功	老练
七十岁学巧	长到老，学到老
七十岁演活报剧	非同儿戏
七十岁中状元	老来喜，老来发奋
七石缸里捞芝麻	费功夫
七仙女放烟花	天女散花
七仙女嫁董永	采取主动
七仙女下凡	好景不长；是非多
七仙女走娘家	云里来；雾里去
七月的荷花	红不久；一时鲜
七月的生柿子	难啃；啃不动
漆匠师傅调颜色	花样多
齐桓公用音仲	不记前仇
骑兵败阵	兵荒马乱
骑兵打胜仗	马到成功
骑兵掉河里	人仰马翻
骑兵队长打冲锋	一马当先
骑兵逛公园	走马观花
骑老虎走冰山	好险；冒险；危险
骑老牛追快马	望尘莫及（比喻别人进步发展快，自己赶不上。）
骑楼下躲雨	暂避一时
骑驴背磨盘	白搭；多此一举
骑驴看唱本	走着瞧
骑驴扛布袋	弄巧成拙；自讨麻烦，蠢人蠢事
骑驴拿拐杖	多此一举
骑驴瞧账本	走着看，到了算
骑驴望着坐轿的	比上不足，比下有余
骑驴找驴	昏头昏脑；昏了头；心不在焉
骑骆驼背大刀	阔马大刀
骑马背包袱	全在马身上
骑马不带鞭	拍马屁
骑马不带鞭子	拍马屁
骑马放屁	两不分明
骑马观灯	走着瞧
骑马逛草原	没完没了；无穷无尽
骑马过独木桥	难回头；回头难
骑马过闹市	岂有此理
骑马扛布袋	白搭
骑马上独木桥	回不得头
骑马上山	步步高升；步步登高
骑马上天山	回头见高低
骑马时间少，擦镫时间多	本末颠倒
骑马找判官	马上见鬼
骑马抓跳蚤	大惊小怪
骑毛驴不用赶	道儿良好；道熟；道儿熟（比喻富于某种经验，做起事来非常熟悉。）
骑毛驴追火车	赶不上趟
骑牛找牛	老糊涂
骑牛追马	望尘莫及
骑兔子拜年	寒碜（han chen丢脸；不体面）
骑在房梁上吹喇叭	名（鸣）声在外
骑着大象数着鸡	高的高来低的低
骑着老虎看美人	贪色不怕死
骑着驴看《三国》	走着瞧：
骑着驴子啃烧鸡	这把骨头不知扔在哪里
骑着驴子思骏马，官居宰相望王侯	贪得无厌；贪心不足
骑着骆驼吃包子	乐颠了馅
骑着骆驼赶鸡	不识高低
骑着骆驼赶着鸡	不知高低；高低不齐
骑着骆驼找骆驼	昏头昏脑；昏了头
骑着毛驴追骏马	望尘莫及
骑自行车过独木桥	小心翼翼
棋盘边上的卒子	有你不多，无你不少
棋盘里的兵率	只进不退
棋盘里的老将	出不了格
棋盘上的士象	不离将
棋盘中的子儿	捻一下，动一步
旗杆顶上放鞭炮	想（响）得高
旗杆顶上拉胡琴	唱高调儿
旗杆顶上贴告示	天晓得；天知道
旗杆尖上拿大鼎	艺高胆大
旗杆上的灯笼	高明（比喻技能或见解高起。）
旗杆上挂地雷	空响
旗杆上挂红灯	照远不照近
旗杆上扎鸡毛	胆子不小；好大的胆（掸）子
蜞蚂儿（青蛙）穿套裤	踢蹬不开；蹬打不开
麒麟角，蛤蟆毛	天下难找
乞丐吃醋	一副穷酸样
乞丐吃梅子	穷酸
乞丐打铃	穷得叮当响
乞丐的衣服	破绽多
乞丐过日子	全靠别人施舍
乞丐进发廊	没人理
乞丐扭秧歌	穷快活
乞丐说相声	耍贫嘴
乞丐跳舞	穷快活
乞丐养猪	没料儿
乞食身，皇帝嘴	不相称
启航赶上了顺船风	机不可失
起个五更，赶个晚集	老落后
起义军打天下	除暴安良
起重机吊灯草	不值一提
起重机吊鸡毛	轻拿；大材小用
起重机吊竹篮	不值一提
气球上天	远走高飞；吹起来了；飘飘然；不攻自破
气球上扎窟窿	泄气
气死周瑜去吊孝	假仁假义；虚情假意
气象大学毕业的	听见就是雨，见闪就是雷
弃美玉而抱顽石	糊涂到顶了
汽车长翅膀	快上加快；飞快
汽车打飞机	差远了；差得远；差一大截子
汽车的后轮	不会拐弯
汽车坏了方向盘	横冲直撞
汽车开进了死胡同	走错了道
汽车亮了尾灯	回光返照
汽车抛锚	不走了
汽车前的大眼睛	顾前不顾后
汽车上的喇叭	不用吹；不是吹的
汽车司机扳舵轮	忽左忽右
汽车死了火	要人推
汽车撞轮船	难得一回
汽锤打夯（da hang用夯把地基砸实）	扎扎实实
汽锤砸钢板	响当当；当当响
砌墙的砖头	后来居上
掐了头的苍蝇	乱撞；不知死活；死活不知
掐了头的树苗	节外生枝
千臂观音	多面手
千层鞋底做腮帮子	好厚的脸皮；脸皮厚
千古的罪人	十恶不赦
千斤担子肩上搁	负担太重
千斤顶干活	不怕压力大
千斤顶伸头	压上劲了
千斤重的种猪	肥头大耳
千里搭长棚	没有不散的筵席
千里打电话	遥相呼应
千里马长翅膀	突飞猛进
千里马逮老鼠	大材小用
千里马拉犁耙	大材小用；用非所长
千里送鹅毛	礼轻情意重；礼薄情意重；物轻人意重
千里送客	总有一别（比喻总有离开的时候。）
千里行军才起步	路长着呢
千里遇知音	喜相逢
千年大树百年松	根深蒂固
千年的大树	根深叶茂；盘根错节
千年的狐狸精	古怪
千年的铜器	老古董
千年的铜钟	经得起打击
千年的野猪	老虎的食（比喻早晚是人家的货。）
千年古树当火棍	大老粗
千年胡椒万年姜	越老越辣
千年槐下乘凉	托前人的福
千年铁树开了花	枯木逢春；得之不易；今古奇观
千人大合唱	异口同声
千日拜佛，一朝添丁	善有善报
千日斧子百日锛（ben削平木料的工具）	苦学苦练
千日管子百日笙	练出来的
千条江河归大海	大势所趋
千条竹篾编花篮	看着容易做着难
牵动荷叶带动藕	互相牵连
牵狗玩猴弄猢狲	不走正道；光走歪道
牵牛过独木桥	难过
牵牛花儿当喇叭吹	闹着玩
牵牛花上树	顺杆爬
牵牛花讨好	顺杆爬
牵牛牵鼻子	抓住了关键
牵牛上独木桥	难过
牵牛上纸桥	难上加难；难上难
牵瘸驴上窟窿桥	左右为难
牵羊进照相馆	出洋（羊）相
牵只羊全家动手	人浮于事
牵着不走，拉着倒退	犟（jiang固执；不服劝导）牛
牵着肠子挂着肚	不放心；放，心不下
牵着骆驼赶着鸡	就高不就低
牵着骆驼数着鸡	高的高来低的低
牵着羊进照相馆	出洋（羊）相
牵着张三（狼的俗称）回家	引狼人室
铅笔芯儿	直肠子；直肠直肚
前脚与后脚	寸步不离
前面挨一枪，后面挨一刀	腹背受敌
前面是狼后面是虎	一个比一个凶
前面是死胡同	行不通
前怕狼后怕虎	进退两难
前妻的孩子哄后娘	尽说瞎话
前有埋伏，后有追兵	进退两难；无处逃生；没有回头的余地
前有强敌后有追兵	进退两难
前有悬崖，后有追	死路一条
钱串子（穿铜钱的绳子。比喻过分看重金钱的人）脑袋	见钱眼开；光钻空子；见缝就钻；钻空子
钱串子脑袋	见窟窿就钻
钱塘江的潮水	看涨
钱塘江里洗被单	大摆布
钱塘江涨潮	大起大落
钱塘江涨大潮	一浪高一浪；后浪推前浪；来势凶猛；涌上来了
钱眼里翻跟头	财迷转向
钱眼里睡觉	细人
钱在手头，食在嘴边	难久留；留不住
钳工师傅教徒弟	动手就错（锉）
潜水艇下水	深人浅出
潜水运动	要沉住气
浅碟子盛水	一眼看透
浅滩上放木排	拖拖拉拉；一拖再拖；拖拉
欠债不还	放赖
欠债还钱	理所当然
枪枪打中靶心	百发百中
枪头上的雀儿	吓破了胆
强逼哑巴说话	逼人太甚
强盗打灯笼	明火执仗
强盗的面孔	贼眉鼠眼
强盗的钱财	来路不明
强盗的欲望	填不满
强盗发善心	难上加难；难得一回
强盗过后安弓箭	没用处；没得用
强盗救火	趁火打劫
强盗拍照片	贼相难看；贼头贼脑
强盗碰着贼爷爷	黑吃黑
强盗敲门	来者不善
强盗杀死赵公元帅（财神）	谋财害命
强盗上了云头星	偷天换日
强盗伸手	偷偷摸摸
强盗偷石磙	笨贼
强盗遇到贼娃子（小偷儿）	一路货
强盗照镜子	贼头贼脑
强盗走了扛出枪来了	假充勇敢（比喻假装积极，冒充英勇。）
强盗做梦	想着偷
强拉媳妇成亲	人在心不在；难得两全
强拉秀才成亲	难为圣人
强扭的瓜儿	不香甜；不甜
强求的婚配	不成
墙缝的蛇咬人	出嘴不出身
墙缝里的坚强不屈蚁	自有路数
墙缝里的蚂蚁	不愁没出路
墙缝里的蝎子	蜇人不显身
墙角开口	邪（斜）门
墙角追狗	回头一口
墙里的柱子	暗中使劲；使暗劲
墙上的壁虎	见缝就钻；钻空子
墙上的饼	中看不中吃，好看不好吃
墙上的葫芦	头重脚轻
墙上的麦子	野种
墙上的茅草	左右摇摆；摇摆不定
墙上的蝎子	专找缝子钻
墙上的蜘蛛网，草原上的脚印	蛛丝马迹
墙上钉撅子	钻劲大；有股钻劲
墙上挂狗皮	不像话（画）；不成话（画）
墙上挂帘子	没门儿；无门
墙上挂琵琶	不谈（弹）了
墙上挂日历	一天变个样
墙上挂王八	上不着天，下不着地；四脚无靠；四爪没抓拿
墙上挂钟馗（kui）	鬼话（画）
墙上画的美人儿	你爱他不爱
墙上画老虎	吓唬人；样子凶
墙上一棵草	两边倒
墙上栽葱	扎不下根；难生根
墙上种黄连	埋头苦干
墙头草随风倒	两面装好人
墙头拉车	路子窄
墙头上的草	摇摇晃晃
墙头上的鸽子	东张西望
墙头上的葫芦	两边滚
墙头上的马蜂，墙缝里的蝎子	一个比一个毒
墙头上跑马	路子窄；好险；转不过弯；寸步难行；没多大奔头；难转弯；危险
墙头上睡觉	难翻身；翻不了身；想得宽
墙头上种白菜	难浇（交）（比喻为人孤僻，很难和别人做朋友。）
墙头上种菜	没缘（园）
墙头种白菜	难交（浇）
抢吃弄破碗	欲速则不达
抢来的媳妇	无情无义
跷跷板上搁鸡蛋	滚开；滚了
劁（qiao 阉割牲畜）猪割耳朵	两头受罪
敲鼓吹口哨	自吹自擂
敲锅盖卖大饼	好大的牌子
敲锅盖卖烧饼	好大的牌子
敲开的木鱼	合不拢嘴（比喻高兴地合不上嘴。）
敲空米缸唱戏	穷开心
敲锣紧跟打鼓的	想（响）到一个点子上
敲锣卖糖	各管一行；各干一行
敲锣撵兔子	起哄
敲锣碰到放炮的	想（响）到一点子上
敲锣找孩子	丢人打家伙
敲锣捉麻雀	一个逮不了（比喻打草惊蛇。）
敲门惊柱子	旁敲侧击
敲山震虎	瞎咋唬
敲头顶脚底响	灵透了
敲下去的钉子	定了
敲着饭碗讨吃的	穷得丁当响
敲着空米缸唱戏	穷开心
敲着空碗唱大戏	穷开心
荞麦地里藏秃子	没有看出你来
荞麦地里抓王八	十拿九稳
荞麦地里捉王八	十拿九稳
荞麦粒儿	有棱有角
荞麦面擀饼	不粘板
荞麦面贴对子	不粘板
荞麦捏的	没有骨头
荞麦皮打浆糊	粘不到一起
荞麦皮打糨子（jiang zi糨糊）	不粘板；两不沾（粘）；粘不到一块儿
荞麦皮里挤油	死抠；没多大油水；油水不大
荞麦皮榨油	无中生有
荞麦去了皮	棱没棱；仁没仁
荞麦窝里扎锥子	奸（尖）对奸（尖）；棱对棱
桥顶上盖搂	上下空
桥孔里插扁担	担不起（比喻负不起责任或不敢当。）
桥孔里伸扁担	担当不起（比喻负不起责任或不敢当。）
桥上搭碉楼	底子空
桥是桥，路是路	清清楚楚；一清二楚
桥头上跑马	走投无路
樵夫卖柴	两头担心（薪）
巧八哥的嘴	能说会道
巧他爹打巧他娘	巧极（急）了
巧他爹遇到巧他娘	巧上加巧
巧媳妇打扮囡（咖小孩儿）	一天变个样
巧媳妇	难做无米之炊（比喻没有材料，手艺再高也白搭；没有条件，能力再强也不行。）
俏大姐的头发	输（梳）得光；波涛滚滚
俏大姐择眉毛	连根拔
俏大姐坐飞机	美上天了
俏媚眼给盲佬看	传错情
俏媚眼做给瞎子看	白搭
俏媳妇戴凤冠	好上加好
翘辫子不叫翘辫子	死了
撬（qiao）杠打蝈蝈儿	小题大做
切菜刀背上翻跟头	武艺高；本领高；好险
切菜刀剃头	好险；冒险；危险
茄藤子上上吊	难死人
茄子炒南瓜	分不清青红皂白
茄子地里长蒺藜（ji li 一年生草本植物。果皮有尖刺）	坏种坏苗
茄子开黄花	变了种
茄子棵上结黄瓜	杂种；变种
窃马贼戴佛珠	冒充善人
亲戚是把锯	你有来，我有去
秦桧的后代	奸小子
秦桧杀岳飞	不得人心
秦桧杀岳飞的罪名	莫须有
秦椒（细长的辣椒）拌姜	辣对辣
秦椒就酒	一口顶两口
秦琼的黄膘马	有来头
秦琼卖马	忍痛割爱；背时
秦始皇的奶奶	有年纪啦
秦始皇收兵器	高枕无忧
秦始皇修长城	千古奇迹；功过后人评
秦始皇修坟墓	自作自受；找死；自己找死
秦始皇治卢生	坑害人
秦叔宝的黄骡马	来头不小
秦叔宝卖马	穷途末路
青芭蕉	有棱有角
青菜煮萝卜	一清（青）二白
青出于蓝而胜于蓝	后来居上
青冈木做扁担	硬杠子；硬邦邦
青龙白虎下界	凶神恶煞（杀）
青皮橄榄	先苦后甜
青石板上搭窝棚	底子好
青石板上的蛐蟮	没处钻了
青石板上雕花	硬功夫；开头难
青石板上钉钉	不动
青石板上抹油	滑得很
青石板上撒石灰	一清（青）二白
青石板上晒棉花	有软有硬
青石板上甩乌龟	硬碰硬
青石进了石灰窑	要留清（青）白在人间
青石上钉钉子	硬钻
青藤缠树	难解难分；你中有我，我中有你；抱得紧
青蛙唱歌儿	呱呱叫
青蛙鼓嗓	不成调
青蛙闹塘	吵闹不休
青蛙爬到鞭梢上	经不起摔打
青蛙爬在脚上	不咬
青蛙拴生鞭梢上	不值摔打
青蛙谈恋爱	吵闹不休
青蛙跳到热鏊（ao烙饼的炊具。铁制圆形平底）上	送死；寻死；自己找死
青蛙跳塘	不懂（扑通）
青蛙望玉兔	有天地之别
青蛙笑蝌蚪	忘了自己从哪来的
青蛙遇田鸡	碰上自家人
青蛙走路	又蹦又跳；连蹦带跳
氢气球上天	扶摇直上；不翼而飞
倾巢的黄蜂	各散四方；一哄（轰）而散
倾倒的篱笆	塌了架
清晨的云雀	展翅飞翔
清道夫拉货	废物
清官断案子	认理不认亲
清洁工遇垃圾	一扫光
清水拌石子	合不拢；合不到一起
清水染白布	空过一场
清水下杂面	你吃我看
清水衙门	一尘不染
清水煮白菜	一清（青）二白
清水煮豆腐	乏味
清油炸麻花	�烤⒍�（biao jin er双方因赌气或竞赛等憋着劲比着（干））；较（绞）上劲儿
清蒸鸭子	身子烂了嘴还过硬
蜻蜓吃尾巴	白吃自；一连串
蜻蜓飞进蜘蛛网	有翅难飞
蜻蜓撼石柱	痴心妄想；自不量力；不自量
蜻蜓撼树	纹丝不动
蜻蜓撞着蜘蛛网	命难逃
蜻蜒吃尾巴	自咬自
蜻蜒点水	东一下，西一下
蜻蜒点水鱼打花	没有用
蜻蜒撞着蜘蛛网	有翅难飞
晴天打雷	空喊；离奇；太离奇
晴天带伞	有备无患
晴天盼下雨	没指望
晴天下雹子	大难临头；灾祸临头；冷不防
晴天下大雪	明明白白
晴天响霹雳	惊天动地；信不得
请个猴子去摘桃	到不了你肚里
请狼来做客	活得不耐烦
请狼做客	活得不耐烦；活够了
请篾匠师傅补锅	找错了人
请木匠补锅	用人不当
请人哭爹妈	假伤心
请小姨子作伴	不安好心眼
请小姨子做伴	没安好心
请修锁的补锅	找错人啦
穷风流，饿快活	苦中作乐；苦中取乐
穷寡妇赶集	要人没人，要钱没钱
穷寡妇回娘家	苦衷难诉
穷寡妇进当铺	人财两空
穷光棍遇到吝啬鬼	谁也不沾谁的光
穷汉匠下饭馆	肚里空，兜里光
穷木匠开张	只有一句（锯）
穷人打官司	场场输
穷人的日子	难熬
穷人点蜡烛	大家借光
穷人告状	输定了
穷人卖儿女	迫不得已
穷人逃债	躲过初一，躲不过十五
穷债户过年	躲躲闪闪
秋蝉落地	闷声不响；闷声闷气；哑了
秋后的芭蕉	一串一串的
秋后的蛤蟆	没几天叫头
秋后的核桃	满人（仁）
秋后的黄蜂	欲凶无力
秋后的蚂蚱	没几天蹦头；蹦达不了几天
秋后的南瓜	皮老心不老
秋后的扇子	没人过问
秋后的丝瓜	满肚子私（丝）；一肚子私（丝）
秋后的蚊子	嗡嗡不了几天；销声匿迹
秋后的知了	没几天叫头
秋后望田头	找茬儿
秋天剥黄麻	扯皮
秋天的高梁	红到顶了
秋天的蚂蚱	难长久
秋天的棉桃	合不拢嘴；咧开了嘴
秋天的木棉花	老来红
秋天的柿子	自来红
蚯蚓变蛟	纵变不高
蚯蚓打哈欠	土气大
蚯蚓戴草帽	土里土气；土气大
蚯蚓戴帽子	土里土气
蚯蚓钓鲤鱼	以小引大
蚯蚓过溪	无以为力
蚯蚓回娘家	弯弯曲曲
蚯蚓爬石板	无地自容
蚯蚓刨地	费力不小，收获不大
蚯蚓找妈妈	走弯路；弯弯曲曲
蚯蚓走路	能曲能伸；以曲求伸
囚犯解解差	倒过来
屈死鬼进衙门	鸣冤叫屈
蛆虫变苍蝇	要飞了
蛐蟮（qu shan 曲蟮。蚯蚓）串门子	土里来，泥里去
蛐蟮过河	弯弯曲曲
娶得媳妇嫁不得女	有进无出
娶了老婆娶小婆	喜新厌旧
娶了媳妇死了娘	又喜又悲；悲喜交加
娶了媳妇忘了娘	白疼一场；忘恩负义
娶媳妇穿孝衫	十里乡情不一般
娶媳妇打发客（女子出嫁）	双喜临门；有来有去
娶媳妇打幡	成心起哄
娶媳妇碰见送殡的	倒霉透了；真倒霉；扫兴
娶媳妇请吹鼓手	大吹大擂
娶媳妇死老娘	哭笑不得
娶媳妇遇见出殡的	有死有活；有哭有笑；哭的哭，笑的笑；倒霉透了；又哭又笑
去了咳嗽添了喘	躲了一灾又一灾；祸不单行
去年的皇历	翻不得
去年的棉衣今年穿	老一套
圈里的肥猪	等着挨刀；早晚得杀
泉水坑里扔石头	一眼看到底
泉水里看石头	清清楚楚；一清二楚
拳师教徒弟	留一手
拳头舂海椒（辣椒）	辣手
拳头打跳蚤	吃亏是自己；白费功夫；白费劲；枉费工
拳头捣锣	没音
拳头捣蒜	辣手
拳头上跑马	能人儿
拳头砸核桃	吃亏是自己；自己吃亏
犬守夜，鸡司晨	各尽其责；各尽其能
缺胳膊的穿坎肩	露一手
缺根竹子照样扎竹排	不希罕你
缺角屏风	提不住门
缺口镊子	一毛不拔
缺口碗盛米汤	放任自流
缺口碗盛稀饭	自流
缺了鼻的瓦罐	没法提
缺腿的老虎	神气不了
缺尾巴虾	掀不起大浪
缺牙巴咬虱子	遇了缘
缺牙啃西瓜	道道多
瘸驴的屈股	邪（斜）门歪道
瘸驴配破磨	两将就
瘸子拜丈人	颠颠簸簸
瘸子踩高跷	早晚有他的好看
瘸子穿大衫	抖起来了
瘸子担水	一步步来
瘸子当差役	用人不当
瘸子的拐棍	离不得
瘸子跌断腿	一蹶不振
瘸子丢了拐杖	寸步难行
瘸子赶山（打猎）	坐着喊
瘸子跟瞎子走	取长补短
瘸子靠着瞎子走	取长补短
瘸子里头挑将军	凑数
瘸子爬山	步步难；东倒西歪
瘸子骑瞎马	互相照应；各显其能；各显神通
瘸子上楼梯	步步难
瘸子跳高	早晚有他的好看
瘸子驼背	卑躬（背弓）屈膝
瘸子携瞎子	高低跟着走
瘸子追小偷	越喊越远
瘸子走山路	东倒西歪
雀屎掉在头顶上	不祥之兆
染布不均	料不到
染坊的常客	好色之徒
染坊的老板	好色
染坊里拜师傅	好色之徒
染坊里吹笛子	有声有色
染坊里的捶布石	经过大家伙
染坊里的大缸	由人摆布；任人摆布
染坊里的姑娘	变了色
染坊里的老板	尽给颜色看
染坊里卖布	多管闲事
染坊师傅送礼	拿不出手；伸不出手来
染房里吹笛子	有声有色
染房里的衣料	任人摆布
染缸里的衣服	变他本色
染缸里的珍珠	上不了色
染缸里落白布	再也洗不清（比喻永远去不掉身上的污点。）
染匠的衣服	不可能不受沾染
染匠提小桶	无法摆布；看你怎么摆布
染匠下河	大摆布；摆布
让结巴念绕回令	强人所难
让了香瓜寻苦瓜	自讨苦吃；自找苦吃
让张飞绣花	滥用人才
饶舌的乌鸦	老调子
热鏊（ao 烙饼用的炊具。铁制圆形平底）上的蚂蚁	走投无路
热包子掉底	露了馅
热包子流糖汁	露馅了
热地上的蚰蜒（you yan 节肢动物。像蜈蚣而略小，生活在阴湿的地方）	坐卧不安；走投无路
热锅爆米花	乱蹦乱跳
热锅炒辣椒	够戗（够受的）
热锅里爆虾米（小虾）	又蹦又跳；连蹦带跳
热锅里的螃蟹	爪子紧挠（比喻十分难受。）
热锅里的鸭子	窝脖
热锅上的黄豆	熟了就蹦；蹦得欢
热锅上的蚂蚁	团团转
热锅上的蚰蜒	团团转
热锅上的蒸笼	好大的气
热火盆里抽火炭	冷落
热炕头的夫妻	难舍难分
热炕头上的白面	发啦
热脸蛋贴人家冷屁股	奴颜媚骨
热恋中的情人	难分开
热面孔碰到冷毛巾	无情
热身子滚到冰窖里	凉了半截
热水瓶脾气	外面冷，里头热
热水瓶	外头凉里头热
热蹄子马	闭不住
热天的扇子	家家忙
热窝炒豆子	熟一个，蹦一个
热窝上的蚂蚁	急得团团转
热油糕放进冰箱里	凉透了
热中送扇雪中送炭	急人之所急
人把狗咬死了	怪事一桩；怪事
人才市场填个表	自我推销
人打江山狗坐殿	抬举畜生
人到矮檐下	不得不低头
人到八十拜花堂	老来喜
人到古稀穿花衣	老来俏
人多主意强	集思广益
人各吃得半升米	哪个怕哪个
人过三十不学艺	老了
人急跳窗户	不是门
人家的棺材抬自家	自讨晦气
人家的牡丹敬菩萨	借花献佛
人家骑马我骑驴，后面还有推车的	比上不足，比下有余
人老还穿儿时衣	过时货
人了洞房生孩子	双喜临门
人了殓写祭文	盖棺论定
人情一把锯	你不来，我不去
人秋的高梁	老来红
人秋的石榴	点子多；点子不少
人身上的汗毛	数不清
人手一把号，各吹各的调	自行其是
人死大夫到	无济于事；不济事
人死了才抓药	晚了；迟了
人死请郎中	白费功夫；框费功；白费劲
人头上长疥疮	毛病
人头上砸核桃	欺人太甚；太欺负人
人心隔肚树隔皮	难相识
人在屋桅下	不得不低头
人造牛黄	冒牌货
人造卫星上天	不翼而飞；惊天动地
人字双着写	不从也得从
人嘴两张皮	各说各有理
扔下讨饭篮打乞丐	忘本
扔下铁锤拿灯草	拈轻怕重
日出西山水倒流	天下奇闻；无奇不有
日落东山水倒流	弥天大谎
日落西山	红不久
日头晒屁股	懒人
日头晒瓮	肚里阴
绒毛鸭子刚下水	新学
绒球打鼓	不想（响）
绒球打脸	吓唬人；不痛不痒
绒球打锣	没有回音（比喻没有回答或没有音信。）
绒球敲锣	打不响
肉案上的买卖	斤斤计较
肉包子打狗	有去无回
肉墩子	油透了
肉骨头打狗	有去无回
肉骨头打鼓	昏（荤）冬冬
肉骨头落锅	肯（啃）定了
肉骨头落了锅	啃（肯）定了（比喻确定无疑。）
肉锅里煮元宵	浑蛋
肉烂了在锅里	不分彼此
肉烂在锅里	肥水不外流
肉烂在汤里	谁也不吃亏
肉秦秦上的买卖	斤斤计较
肉汤里煮元宵	混（荤）蛋
肉丸子掉进煤堆里	漆黑一团
如来佛出虚恭（放屁）	好神气
如来佛打喷嚏（pen ti）	非同小可
如来佛的手心	谁也甭（beng不用）想逃出去
如来佛掌上翻跟头	跳不出去
如来佛治孙悟空	强中还有强中手
如来佛捉孙大圣	易如反掌
入伏的高粱	天天向上
入伍穿军装	头一回；头一遭
软刀子割头	不知死活；死活不知
软骨头卡在喉咙里	张口结舌
软面包饺子	好捏
软面包一块	随人捏
软索套猛虎	柔能克刚
软藤绑硬柴	服服帖帖
软枣（黑枣）树上结柿子	小事（柿）一宗
仨钱买，俩钱卖	不图赚钱只图快
仨钱买匹马	自骑自夸（跨）
仨钱买头老叫驴（公驴）	浑身是毛病；贱货
仨月不梳头	不顾脸面
塞翁失马	因祸得福
腮帮贴膏药	不留脸面
腮帮子上拔火罐	顾不得脸面；不顾脸面
赛马场上的冠军	一马当先
三把钥匙挂胸膛	开心开心真开心
三百斤的野猪	得个大嘴（比喻能吃。）
三百钱买包花生米	吃不了兜着走
三百钱买个土地爷	钱能通神
三本经书掉了两本	一本正经
三岔口的地保	管得宽
三尺长的被单	顾头不顾脚
三尺长的锯子	又拉又推
三尺长的梯子	搭不上言（檐）
三尺门槛	高抬不上
三代人出门	扶老携幼
三顶帽子四人戴	难周全
三分面粉七分水	十分糊涂
三分面加七分水	十分糊涂
三分钱的胡椒粉	一小撮
三分钱的烧饼	大不了
三分钱开当铺	小买卖
三分钱买把二胡	要腔没腔，要调没调
三分钱买个臭猪蹄	贱货
三分钱买个鸭头	嘴贱
三分钱买烧饼看厚薄	小气鬼
三分钱买烧还看厚簿	小气得很
三分人才七分鬼	人不像人，鬼不像鬼
三伏天穿皮袄	不是时候，不识时务；乱套了
三伏天的爆竹	一碰就炸
三伏天的冰雹	来者不善
三伏天的冰棍	人人喜欢；个个喜爱
三伏天的冰块	见不得阳光
三伏天的电扇	忙得团团转
三伏天的隔夜饭	臭货
三伏天的狗	喘不上气；上气不接下气
三伏天的庄稼	一天变个样
三伏天孵小鸡	坏蛋；坏蛋多
三伏天喝冰水	正中下怀
三伏天喝凉茶	正是时候
三伏天烧炉子	真够热火
三伏天絮棉袄	闲时预备忙时用
三斧头砍不入的脸	好厚的脸皮；厚脸皮
三个半人抓螃蟹	七手八脚
三个鼻孔眼儿	多一股子气
三个臭皮匠	顶个诸葛亮
三个厨子杀六只鸡	手忙脚乱
三个老爷两顶轿	哪有你的份；哪里轮得到你
三个菩萨两炷香	没有你的份
三个钱买个牛肚子	尽吵（草）
三个钱买个媳妇	贱人
三个钱买个猪头	就是一张嘴
三个钱买条毛驴	自骑自夸
三个钱买猪头	就是一张嘴（比喻嘴好，会说话。）
三个人讲两句话	哪能轮到你
三个铜子放两处	一是一，二是二
三个头头一个兵	不知听谁的
三个土地堂	妙（庙）妙（庙）妙（庙）
三个小鬼丢了俩	失魂落魄
三个指头捡田螺	十拿九稳
三个醉汉撒酒疯	闹个不停
三根缆绳拴两边	使偏劲
三根屎棍撑个瘦肩膀	摆臭架子
三更半夜见太阳	离奇；太离谱
三更已过	晚了
三股弦断了两根	谈（弹）不得
三棍子打不出屁来	老实到家了；老实疙瘩
三过家门而不入	公而忘私
三合板上雕花	刻薄
三花脸照镜子	鬼样子；鬼脸
三加二减五	等于零
三间房子不开门	怪物（屋）
三间房子两头住	谁也不认谁
三间瓦房不开门	怪物（屋）
三角锉刀	面面有用
三角砖头	摆不平
三脚板凳	一推便倒；碰不得；不牢靠
三脚凳子搭床脚	坐卧不安；坐卧不宁
三脚猫	到处跑
三斤半干饭没吃饱	饭桶
三斤半鸭子两斤半嘴	多嘴多舌
三斤面包个包子	好大的面皮；皮厚
三斤面包个扁食（饺子）	好大的面皮；皮厚
三九穿单褂	威风不起来
三九天不穿棉	缩手缩脚
三九天吃冰棍	寒心；冷暖自己知
三九天吃梅子	寒酸
三九天穿单褂	抖起来了；威风不起来
三九天穿裙子	美丽又动（冻）人
三九天的冰棍	没人理
三九天的豆腐干	冷冰冰，硬邦邦
三九天的叫花子	又冷又饿
三九天掉冰窟	抖起来了
三九天喝姜汤	热心肠
三九天喝凉水	从里凉到外
三九天扇扇子	心里有火
三九天送皮袄	暖人心
三九天送扇子	不领情
三九天谈心	冷言冷语
三九天桃花开	罕见；太离奇；稀奇古怪
三九天种小麦	不是时候
三句话不离本行	干啥说啥
三两棉花十张弓	谈（弹）不得
三两银子放账	稀（息）少（比喻很珍贵、少见）
三流子哥大流子弟	二流子
三毛的头发	稀少
三亩地里一棵谷	单根独苗；独苗苗
三亩棉花三亩稻	睛也好，雨也好
三亩竹园出棵笋	独一无二；物以稀为贵
三年不漱口	一张臭嘴；臭嘴
三年不知肉味	不吃香
三年没人登门槛	孤家寡人
三平加一竖	妄想称王
三千丈的悬崖	高不可攀
三枪打了二十七环	八九不离十
三亲六故，四朋八友	一拉一帮（比喻拉帮结伙搞宗派）
三人过独木桥	有先有后
三色圆珠笔	多心
三十斤干饭没吃饱	十足的饭桶
三十里地不换肩	担子越来越重
三十亩地一头牛	安居乐业
三十年的旧棉絮	老套子
三十三颗荞麦九十九道棱	一成不变
三十晚上熬夜	送旧迎新
三十晚上逼债	年关难过
三十晚上吃年饭	没外人
三十晚上借蒸笼	不是时候
三十晚上盼初一	指日可待
三十晚上盼月亮	没指望
三十晚上走路	没影子
三岁的娃娃	贵在纯真
三岁死了娘	说来话长
三岁小孩买棺材	早做准备
三岁小孩贴对联	上下不分
三堂审苏三	真相大白
三套锣鼓娶媳妇	满红火
三天不睡觉	没精打采
三天不偷装老大	假正经；假装正经
三天打鱼，两天晒网	磨洋工
三天卖不出去的猪下水	心肠坏；一副坏心肠
三条腿的蛤蟆	怪物；与众不同
三条腿的驴	没多大奔头
三条腿的毛驴	没跑；跑不了
三下五除二	干脆利落
三下子去了两下子	就这一下子
三仙姑传道	一人一个说法
三仙姑撒泼	装神弄鬼
三眼枪打兔子	没准儿
三月的冰河	开了动（冻）
三月的菜薹	早有心；不嫩
三月的樱花	谢了
三月的樱桃	红火一片；红不久
三月间的芥菜	另有心；起了心
三月里的菜苔	早起了心
三月里扇扇子	满面春风；春风满面
三月龙舟逆水去	力争上游；个个出力
三月栽薯四月挖	急不可待；急于求成
三张纸画个鼻子	脸面不小；好大的脸面
三丈长的扁担	摸不着头尾
三只手（小偷）管粮仓	不放心；放心不下
三锥子扎不出一滴血	老牛筋；皮厚
伞铺的伙计	轮（淋）不着你
散了的线团	难理清
散了架的南瓜棚	支撑不开
桑木扁担	宁折不弯
桑葚落地	熟透了
嗓门里喷胡椒面	够戗（够受的）
嗓子里塞棉花	喘不上气；上气不接下气
嗓子眼里长骨头	有口难言
嗓子眼里卡鱼刺	上不上，下不下
丧家的狗	东游西走；无家可归
丧屋里的人唱戏	又喜又悲；悲喜交加
骚狐狸见不得关二爷	邪不压正
扫把赶客	不留情面
扫把写字	大话（画）
扫把星	败事种
扫地打跟头	成心起哄
扫帚打跟头	成精作怪
扫帚戴草帽	混充人；装人样
扫帚的脾气	向外不向里
扫帚颠倒竖	没大没小（比喻没有礼貌，老少不分。）
扫帚顶门	光出岔子；净岔子
扫帚画花	粗枝大叶
扫帚头上戴帽子	不算人；不是人
扫帚写家书	说大话
扫帚作揖	拜把子（朋友结为异姓兄弟）
埽，鼻子戴眼镜	没着落；靠不住；没处搁
瘙（jue 刨土用的农具）把对炮筒	直对直
色盲病人	不分青红皂白
森林里烤火	就地取材（柴）
森林里撒网	瞎张罗
森林里生火	就地取材（柴）
森林里野炊	有的是才（柴）
森林失火	尽光棍；全是光棍
杀凳边的猪	活不及；活不长
杀鸡的刀子	派不上大用场
杀鸡割破胆	自讨苦吃
杀鸡取蛋	得不偿失；只图一回
杀鸡取卵，打鹿取茸	得木偿失；因小失大
杀鸡问客	多此一举；虚情假义
杀鸡用牛刀	小题大做
杀鸡做豆腐	称不得里手
杀妻求将	官迷心窍
杀人不见血	心狠手辣
杀人不用刀枪	软收拾
杀人不眨眼睛	凶残
杀人的偿命，借债的还钱	理应如此；理所当然
杀人和尚念佛经	假慈悲；假慈善
杀人越货的强盗	凶相毕露
杀死的公鸡扑棱翅	垂死挣扎
杀死娃娃敬菩萨	人也整死了，神也得罪了
杀猪不吹	蔫退（火退）
杀猪不褪毛	先吹起来看
杀猪刀子刮胡子	太悬乎
杀猪的刀	要快
杀猪的遇到拦路	都有家伙
杀猪分下水	人人挂心肠
杀猪割耳朵	不是要害
杀猪开膛	搜肠刮肚
杀猪捅屁股	外行；各有各的手法
杀猪用铅笔刀	全凭诀窍
沙坝上写字	要不得就抹
沙地拔萝卜	干脆利索；干净利索
沙地上推小车	一步一个脚印
沙锅炒豆子	崩了
沙锅打狼	没有一个好的
沙锅里炒胡豆	抓不开
沙锅里捣蒜	一锤子买卖；一锤交易；露底了
沙锅里煮皮球	滚蛋
沙和尚挑行李	义不容辞
沙姜治跳蚤	一物降一物
沙梨打癞蛤蟆	一对疙瘩货
沙里淘金	有不多
沙漠里播种	一无所获
沙漠里踩高跷	不是路
沙漠里的红柳	不怕风沙
沙漠里的骆驼	处处留迹
沙漠里的水	点滴都可贵
沙漠里的鸵鸟	顾头不顾尾；顾头不顾腚
沙漠里的舟船	寸步难行
沙漠里烤火	就地取材（柴）
沙漠里撵小偷	跟踪追击
沙漠里盼水喝	干着急
沙丘的家	不定
沙瓤西瓜吃到嘴	甜在心上；甜透了心
沙滩里栽花	扎不下根；难生根
沙滩上的黄鳝	滑不到哪里去
沙滩上的楼阁	基础不牢；太悬乎
沙滩上的螺蛳	难开口；不好开口
沙滩上的石子	俯拾即是
沙滩上的鱼	干蹦干跳
沙滩上盖房	根基不牢
沙滩上盖楼房	基础差；底子不行；不牢靠；不稳当
沙滩上拣小米	不够工夫钱
沙滩上浇油	白搭
沙滩上行船	进退两难
沙滩上寻针	难极了
沙滩上种水稻	难办
沙滩上走路	一步一个脚印
沙滩行船	进退两难；干吃力
沙土岗子发洪水	泥沙俱下
沙土井	淘不深（比喻进行不了，深入不进去。）
沙土里的花生	一串一串的
沙窝里种荞麦	不成
沙子垒坝	白费工夫；白费劲；枉费工
沙子里淘金	积少成多
沙子筑坝	难上加难；后患无穷；一冲便跨
纱绢当做粗布卖	不知好歹；好歹不分
砂锅里的火药	容不得半点火星
鲨鱼钩钓虾米（小虾）	小题大做
鲨鱼学黄鳝	尽想滑
傻大姐唱歌	太离谱
傻大姐弹竖琴	不知道拔哪根弦
傻大姐的画	图赖
傻大姐下棋	见一步走一步
傻二哥算账	糊糊涂涂；糊里糊涂
傻二小吊孝	哭了半天，不知死的是谁
傻瓜做媒	坑两头
傻女婿娶个呆闺女	凑合着过；混着过
傻小子拜年	光磕头不说话
傻小子不识打更	敲竹杠
傻小子不识货	拣大的摸
傻小子拉二胡	自顾自（吱咕吱）
傻小子爬墙头	四下无门；四路无门
傻子吃荷叶肉	解不开；不解
傻子打老子	白挨
傻子赶庙会	东张西望；光图热闹
傻子活了九十八	虚度年华
傻子捡柴禾	就认准这条道儿
傻子看戏	白搭工；不明不白
傻子睡凉炕	全凭时气壮
傻子洗泥巴	闲着没事干
傻子中状元	难得的好处
筛沙的筛子	缺点多；尽缺点
筛眼里的米	上不上；下不下
筛子当水桶	漏洞百出
筛子挡门	眼睛多；心眼多
筛子挡太阳	不顶用；不顶事
筛子放哨	心眼多；眼睛多
筛子改锅盖	有边有眼
筛子里的米粒	无孔不入
筛子盛水	一场空
筛子脱坯	不妨（方）
筛子装水	漏洞百出；漏洞多
筛子做锅盖	心眼多；气不打一处来；到处泄气
晒干的蛤蟆	干瞪眼；白瞪眼
晒干的黑枣	缩成一团
晒干的萝卜	蔫（nian花木、水果等因失去所含水分而萎缩）了
晒干的牛粪	文制制
晒过的麻杆	宁折不弯
晒裂的葫芦	开窍了
山坳上的松树	饱经风霜
山半腰遇大虫（老虎）	心惊肉跳
山半腰遭雨淋	上下两难
山差别额头的肉	没有多少油水
山顶喊话山下答	上下呼应；遥相呼应
山顶上安电扇	占上风
山顶上打井	徒劳无益
山顶上的蘑菇	根子硬
山顶上点灯	四方有名（明）；高明
山顶上敲锣	名（鸣）声远扬；远近闻名（鸣）
山东的骡子学马叫	南腔北调
山东跑到山西	两岔
山洞里开河	只进不出
山沟里的人家	零零散散
山沟里的田鸡	目光短浅
山谷里喊话	空喊；一呼百应
山洪冲石子	不滚也得滚
山猴爬树	拿手好戏
山猴子爬树	拿手的戏
山鸡变孔雀	越变越好
山鸡娶凤凰	不般配
山尖上摘月亮	办不到；没法办
山间竹笋	嘴尖皮厚腹中空
山涧发洪水	势不可挡
山狸子（豹猫）进寨	无事不来
山里的狐狸	狡猾透了
山里的石头	雷打不烂；风吹不动；数不清
山里的五步蛇	毒极了；最毒
山里的竹笋	钻劲大；有股钻劲
山里红包粽子	没找（枣）
山里红	中看不中吃；好看不好吃
山里人有柴烧，岸边人有鱼虾	靠山吃山，靠水吃水
山里头打锣	有回音
山坡滚石头	砸啦
山坡上的弯腰树	伸不直腰；难治（直）
山坡上烤火	就地取材（柴）
山坡上烧火	就地取材
山泉出洞	细水长流
山雀子相会	唧唧喳喳
山上的石头，田里莠草	不足为奇
山上的松柏	四季常青；根深叶茂；饱经风霜
山上的竹子	内部空虚
山上钓鱼	财迷转向
山上开梯田	步步高
山上溜冰	滑坡
山头放纸鸢	出手高
山头上吹喇叭	名（鸣）声远扬
山头上搭戏台	高高在上
山头上打虎	高名在外
山头上的草	根子硬
山头上对歌	一唱一和
山头上看飞机	高瞻远瞩
山西猴子河南人耍	各有拿手好戏
山西老乡	爱吃醋
山崖上的野葡萄	一串一串的
山崖上滚鸡蛋	没有一个好货
山羊爱石山，绵羊恋草滩	各有所好；各人所好
山羊吃薄荷	食而不知其味；全不知味
山羊打架	勾心斗角
山羊额头的肉	没多大油水；油水不大
山羊见了老虎皮	望而生畏
山羊拉屎	稀稀拉拉
山羊拴在竹园里	乱缠；缠住了
山羊野马在一起	不合群
山腰的枯树	七枝八权
山腰里一片云	成不了气候；不成气候
山要崩拿绳索捆	白费功夫；白费劲；枉费功
山要崩拿绳子箍	杠费心机
山鹰的眼睛	尖锐
山鹰站在崖顶上	站得高，看得远；登高望远
山中的小溪	掀不起大浪
山中的野猪	嘴巴好厉害
山中无老虎	猴子称大王
山猪嘴里的龅牙（bao ya突出嘴唇外的牙齿）	包不住
山字垛山字	请出
扇蒲扇打蚊子	一举两得
扇着扇子拉风箱	两头受气
扇着扇子聊天	说风凉话
扇子驱大雾	办不到；没法办
鳝鱼的脑袋	又奸（尖）又猾（滑）
伤风鼻塞	嗅觉不灵
伤风流鼻涕	甩了
伤口上长毒疮	坏到一块了
伤了皮毛	无伤大体
商店橱窗里的摆设	样子货
商店里的样品	摆设
商人卖布	让话还钱
赏月偏遇连阴天	扫兴
上岸的鱼虾	干蹦干跳
上朝不带奏折	忘本
上等牙刷	一毛不拔
上帝的父亲	天知道是谁
上吊的遇上济公	想死死不了
上房拆梯子	不留后路；断人后路
上坟不摆刀头肉	哄鬼；骗鬼；哄死人
上坟不带烧纸	惹祖宗生气
上轿才扎耳朵眼	临时忙;临时突击
上街买萝卜	要的心里美
上街买帽子	对头
上梁请了箍桶匠	找错了人
上梁请铁匠	找错了人
上了羁绊的骡子	踢打不开（比喻应付不了。）
上了笼头的骡子	踢蹬不开；蹬打不开
上了山顶想飞天	贪得无厌
上了套的牲口	听喝的
上了弦的箭	一触即发
上满了发条的钟表	一分一秒不休息
上山背毛竹	顾前不顾后
上山背石头	真笨
上山采竹笋	拔尖
上山钓鱼	财迷转向
上山砍柴，过河脱鞋	到哪说哪
上山砍柴卖，下山买柴烧	多一道手续
上市的螃蟹	横行不了几天
上市的乌龟	得缩头时且缩头；缩头缩脑
上树打跟头	爬得高；跌得重；登高必跌重
上树逮麻雀	连窝端
上树捉鱼虾	空扑一场
上膛的子弹	一触即发
上套的猴子	任人耍；由人玩耍
上梯子摘星星	够不着
上天的风筝	靠人牵线
上天的气球	飘飘然
上天摘星星	异想天开，想人非非（飞飞）
上吐下泻	两头忙
上午栽树，下午乘凉	急不可待
上午栽树，下午取材	性太急
上弦的月亮	两头奸（尖）
上鞋（把鞋帮鞋底缝在一起）不用锥子	真（针）好
上绣的剪刀	口难开；不好开口
上锈的铁锁	难开窍；不开窍
上眼皮长瘤子	碍眼
上眼皮看下眼皮	目光短浅
上阵相杀	怕不得
上嘴唇顶天，下嘴唇挨地	不是凡人
尚方宝剑在手	可以先斩后奏
捎马子里摸花生豆	大把地抓
捎马子里装针	容易出头
烧袄灭虱子	不上算；不合算
烧饼铺里的耗子	次（吃）货
烧房子捡钉子	得不偿失
烧干的锅炉	气炸了；气崩了
烧红的，生铁	越打越硬
烧红的火箸（huo zhu 捅火用的铁棍）	难拿
烧红的烙铁	烫手；摸不得；挨不得
烧红了的煤球	吹也吹不得，拍也拍不得；吹不得；捧不得
烧红了生铁	越打越硬（比喻非常坚强，宁可皮肉受苦也不肯暴露党的机密）
烧火剥葱	各管一工
烧火不旺	天才（添柴）
烧火棍子	一头热；一头冷来一头热
烧焦了的米饭	凑合着吃
烧了三炷香，放了七个屁	行善没有作恶多
烧煤油炉子	火不打一处来
烧屋赶耗子	不合算；得不偿失
烧屋赶老鼠	不合算
烧香赶和尚	喧宾夺主
烧香赶走和尚	喧宾夺主（比喻次要的压倒主要的。）
烧香碰倒菩萨	冒失鬼
烧香惹鬼叫	好心不得好报
烧香顺便看和尚	一举两得
烧香忘磕头	顾此失彼；未尽心意
烧香遇到活菩萨	求之不得
烧香砸菩萨	不知好歹；好歹不分
烧窑的盖房子	一举两得
烧窑的卖瓦的	都是一路货
烧窑师傅掂火箸	（倒霉）捣煤
少林寺的高僧	身手不凡
少林寺的和尚	名扬四海
少时衣裳老来穿	过时货
少时衣裳老时穿	过时的货
少小离家老大回	不相识；面目全非
舌尖上搽胭脂	嘴里漂亮
舌头长疮	难开腔
舌头磨剃头刀	冒险；危险
舌头绕到牛桩上	胡缠；胡搅蛮缠
舌头上抹胶	张口结舌
舌头上生疥疮	说不出话来
佘太君百岁挂帅	朝中无人了
佘太君的龙头拐杖	有钱也买不到
佘太君挂帅	马到成功
蛇被抓住了七寸	浑身酥软
蛇入曲洞	退路难
蛇入筒中	曲性在
蛇头上的苍蝇	自送一口肉；送来的口食
蛇吞扁担	直脖啦
蛇吞老鼠鹰叼蛇	一物降一物
蛇吞象	不自量；好大的胃口
蛇吞蝎子	以毒攻毒
蛇遭蝎子蜇	一个比一个毒
蛇钻窟窿	顾前不顾后
蛇钻竹筒	没有回头的余地
舍得买马，无钱置鞍	大处不算小处算
舍了脊梁护胸膛	顾前不顾后
舍身崖边弹琵琶	临危不乱
舍身崖上摘牡丹	贪花不顾生死
射出的箭，泼出的水	难收回；收不回来
射击场上的靶子	漏洞百出
射箭没靶子	无的放矢
麝香的味	包不住
伸脖子套绞索	送死；寻死；自己找死
身上拔汗毛	无伤大体；无关大体
身上背筛子	浑身是窟窿
深山的石头	有的是；多的是
深山老林的枯树	无用之材
深山里打猎，大海里捕鱼	靠山吃山，靠水吃水
深山里的白脸狼	成群结队；三五成群
深山里的小庙	冷冷清清；没见过香火
深山里敲钟	名（鸣）声在外
深山小庙的菩萨	没见过大香火；没人侍奉；默默无闻
神龛（kan）上戳窟窿	妙（庙）透了
神龛上挂粪桶	糟踏神像
神枪手打靶	十拿九稳
神台上的狗屎	神憎鬼厌
神堂里的鸡子儿（鸡蛋）	宝贝蛋
神仙打架	劝不得；凡人遭殃
神仙女儿下凡间	一天配良缘（比喻天生的一对。）
神仙女下凡间	天配良缘
神像背后有窟窿	妙（庙）秀啦
神像拍胸口	没心没肝
审判员入狱	执法犯法
升不离斗，秤不离砣，筛子不离筐和箩	各有各的搭档
升子盖盆子	随方就圆；随得方就得圆
生剥刺猬	难下手；下不了手；无法下手
生成的矬子（cuo zi 个子矮的人）	高不了
生成的骨头长就的肉	定了
生成的眉毛，长成的痣	更改不掉；定型了
生成的相，做成的酱	变不了；没法变
生虫的拐杖	靠不住；不可靠
生虫的核桃	不是好人（仁）
生姜脱不了辣气	本性难移
生就的驼子	直不了
生就的尾巴长就的相	变不了；没法变
生米煮成了熟饭	改不过来
生气踢石头	吃亏是自己；自己吃亏
生铁换豆腐	吃软不吃硬
生铁进了铁匠炉	挨锤的货
生铁犁头	宁折不弯
生吞蜈蚣	百爪挠心；挠心
生锈的剪刀	口难开
生盐拌韭菜	各有所爱
牲口不上膘	料不到
牲口进磨道	兜圈子
绳索套在脖子上	越扯越紧
绳索套在马颈上	身不由己；不由自主
绳子牵羊羔	让它往哪里走，它跟着往哪里走
绳子拴石头	穷得叮哨响
圣人从军	能文能武；文武双全
圣人盗书	文明人不做文明事
圣人肚，杂货铺	难不住
圣人喝卤水	明白人办糊涂事
圣人门前卖文章	自不量力；不自量
圣人遭雷击	好心不得好报
盛开的杜鹃	越来越红火
盛开的木棉花	红透了；红火一片；一片红火
盛头挂在胸口上	挖空心思
失火唱山歌	幸灾乐祸
失火踢倒油罐子	火上浇油
失灵的汽车	横冲直撞
失群的大雁	孤孤单单
失踪的飞机	下落不明；不知下落
师傅长胡子	老把势
师傅当丈人	亲上加亲
师傅收儿当徒弟	一辈传一辈
师字去了横	真帅
虱子躲在皮袄里	有住的，没吃的
虱子钻进麻布眼	伸头容易缩头难
狮子滚绣球	大头在后面；大的在后头
狮子龙灯一起舞	热闹非凡；好热闹；张牙舞爪
狮子配老虎	十全十美
狮子头上捕苍蝇	胆子不小；好大胆
狮子尾巴摇铜铃	热闹在后头
湿柴火烧锅	憋气又窝火
湿身滚进石灰堆	难脱身；脱不了身
湿手扒石灰	难脱手
湿手捏干面	沾上了
湿手抓面粉	沾小便宜
湿手抓石灰	甩不脱
湿水被盖身上	从头凉到脚
湿水的大鼓	不想（响）
湿水的炮仗（爆竹）	不想（响）；想（响）不起来
湿水棉花	谈（弹）不得；无法谈（弹）
湿灶烧湿柴	有火发不出；有火没处发
湿竹竿做笛子	吹不响
十八口子乱当家	各自为政
十八里地保	管得宽
十八罗汉斗悟空	各显神通；大打出手；各显其能
十八岁当博士	少年老成
十八只唢呐齐奏	全吹了
十步九回头	难舍难分
十冬腊月出房门	动（冻）手动（冻）脚
十冬腊月的鼓风机	吹冷风；专吹冷风
十冬腊月掉水缸	凉了半截
十二寡妇征西	全家都上
十二艘轮船出海	四通八达
十二岁做媳妇	不懂事；啥事不懂
十二月说梦话	夜长梦多
十个人排四队	三三两两
十个铜板少一文	久闻（九文）
十个指头按跳蚤	一个也捉不住
十个指头生疮	毒手
十个指头做事	同心协力
十里高山观景致	上得高，看得远；登高望远
十两酒装进一斤瓶	正好
十两纹银㈠日时称成色最好的银子）	一定（锭）
十亩园里一棵草	单根独苗
十亩竹园一根笋	格外珍贵；独一无二
十年寒窗中状元	先苦后甜
十年无战事	安居乐业
十三陵的石人	站惯了的
十套锣鼓一齐敲	热闹
十天九雨	缺少情（晴）意
十天跑完万里长城	一日千里
十五把铡刀铡草	七上八下
十五的月亮	完美无缺；圆圆满满
十五个吊桶打水	七上八下
十五个妇女拉家常	七嘴八舌
十五个聋子问路	七喊八叫
十五个瘸子拜年	七高八低
十五个人当家	七嘴八舌
十五个人睡两头	七颠八倒
十五个人抬木头	七手八脚
十五个驼子睡一炕	七拱八翘
十五个瓦盆摔山下	七零八落
十五个小孩打闹	七哭八笑
十五个小孩睡当院	横七竖八
十五根秫秸（shu jie）当标杆	七长八短
十五块板子做桌面	七拼八凑
十五面锣鼓一齐敲	七想（响）八想（响）
十五盘菜放两处	七荤八素
十五只老鼠打架	七抓八扯
十五只小船出海	七颠八倒
十五只蜘蛛结网	七勾八扯
十月的芥菜	齐心
十月的螃蟹	横行不了几天
十月里的鸡冠花	老来红
十盏明灯熄五盏	半明半不明
十指戴满金镏子（金戒指）	摆阔气
十字街头迷了向	晕头转向；糊涂东西
十字街头遇亲人	巧相逢
十字路口分手	各奔前程
十字路口迷了向	不知走哪条路
十字路口贴告示	众所周知
十字路口行车	四通八达
十字路头摔跟头	分不清东南西北
石板地上插杨柳	难生根
石板桥上跑马	不留痕迹
石板上的泥鳅	钻不进
石板上钉钉	硬碰硬
石板上砍鱼	难下刀
石板上烙馍	面生
石板上斩狗肠	一刀两断
石板上植树	劳民伤财
石板上种瓜	难发芽
石板栽花	靠不住；不可靠
石地板，铁扫把	硬碰硬
石缝里的山药	两受夹；两头受挤
石缝里的笋	强出头
石缝里塞棉花	软硬兼施
石敢当（旧时竖于墙脚用以镇邪的小石碑）搬家	挖墙脚
石膏点豆腐	一物降一物
石膏店的老板	白手起家
石磙点灯	照常（场）
石灰拌白糖	两不分明
石灰布袋	处处留迹
石灰点眼	自找难看
石灰店里买眼药	走错了门；找错了门
石灰堆里的耗子	白眼看人
石灰铺路	白走
石灰刷烟囱	表里不一
石灰水泼到青石板上	清清（青青）白白
石灰水刷标语	净写别（白）字
石灰窑里安电灯	明明白白；明白
石灰窑里打跟头	白走一遭
石灰遭毒打	平白无故
石匠打铁	不会看火色；看不出火候来
石匠的钢钎	挨敲的货
石匠的凿子	专拣硬的克
石匠会铁匠	硬对硬
石匠师傅卖豆腐	软硬兼施
石臼里舂线团	捣乱
石臼里放鸡蛋	稳稳当当
石臼里装阎罗	捣鬼
石臼做帽子	难顶难撑
石榔头打石桩	实（石）打实（石）
石榴花开	老来红
石榴脑袋	点子多；点子不少
石榴树做棺材	横竖不够料
石马塞进车辕里	生搬硬套
石菩萨的眼睛	有眼无珠
石人张嘴	没话
石狮子得病	不可救药
石狮子的鼻子	难开窍；不开窍
石狮子的脑袋	七窍不通
石狮子的屁股	没门儿；无门儿
石狮子的眼睛	动不得
石狮子灌米汤	滴水不进
石狮子赛跑	寸步难行
石头出汗	回潮了
石头打的锁	不开窍；难开窍
石头打着乌鸦嘴	硬碰硬
石头蛋子生病	不可救药
石头蛋子腌咸菜	一言（盐）难尽（进）
石头缝里长竹笋	憋出来的
石头缝里常春藤	两受夹；两头受挤根子硬
石头缝里挤水	异想天开
石头缝里捉鳖	十拿九稳
石头开花马生角	没人见过；没有的事
石头脑袋秤砣心	死心眼
石头脑瓜子	难开窍；不开窍
石头人开口	说实（石）话
石头人嘴里灌米汤	滴水不进
石头上磨刀	硬对硬
石头上绣花	起头难
石头上栽葱	劳而无功；白费工夫
石头上栽花	得不偿失
石头烧豆腐	软硬不均
石头锁子	一点心眼也没有；缺少心眼；没心眼；没法开
石头心肠	又冷又硬
石头压咸菜	一言（盐）难尽（进）
石头扎针灸	没反应
石头子地里摔跤	碰得头破血流
石头子孵小鸡	一成不变
石头做的心	无情无义：
石头做屋基	永世不得翻身
石头做枕头	自讨苦吃
石崖压着嫩枝芽	抬不起头来
实心棒槌灌米汤	滴水不进
实心竹子吹火	一窍不通；不通
实心竹子	一窍不通；不通
实心竹子做笛子	吹不响
拾柴打兔子	一举两得；两不耽误
拾到鸡毛当令箭	少见多怪
拾到金娃找它妈	贪心不足
拾粪老汉起五更	找死（屎）；寻死（屎）
拾个秤砣砸烂锅	得不偿失
拾麦打火烧（做烧饼）	干捞
拾钱不认街坊	见利忘义
拾钱出告示	不贪意外之财
拾食盒上树	吉（沿）之（枝）有理（礼）
拾芝麻凑斗	非一日之功；积少成多
食堂的炒菜锅	油透了
史进偷鸡	祸从口出
屎猴儿（屎壳郎）搬家	臭折腾
屎猴儿照镜子	臭美
屎壳郎搬家	臭折腾；走到哪臭到哪；走一路臭一路
屎壳郎变知了	一步群天：高升了
屎壳郎吃蛆虫	臭味相投
屎壳郎出国	臭名远扬
屎壳郎传宗接代	遗臭万年
屎壳郎吹喇叭	满嘴放臭气；臭吹
屎壳郎打饱嗝儿	满嘴喷粪
屎壳郎打哈欠	臭不可闻；一张臭嘴
屎壳郎戴耳环	摆臭阔气
屎壳郎戴花	臭美
屎壳郎戴礼帽	出洋相；洋相百出
屎壳郎戴面具	臭不要脸
屎壳郎掉进尿盆里	又臊又臭；臊臭
屎壳郎掉进阴沟里	随波逐流
屎壳郎跌粪坑	饱餐一顿；死（屎）里求生
屎壳郎跌炉灶	凶多吉少
屎壳郎放屁	不值一文（闻）
屎壳郎飞进桂花园	一阵香，一阵臭
屎壳郎跟着蝙蝠飞	迟早要碰壁
屎壳郎跟着孔雀飞	变不成俊鸟
屎壳郎滚粪蛋	走回头路；倒退
屎壳郎滚煤球	找错了对象
屎壳郎嫁蝽象	臭味相投
屎壳郎叫门	臭到家了
屎壳郎扛大旗	臭名昭著
屎壳郎爬鞭梢	光知腾云驾雾，不知死在跟前
屎壳郎爬到茧棚上	结不成什么茧
屎壳郎爬到牛角尖里	绝路一条；此路不通
屎壳郎爬到书本上	冒充圣人
屎壳郎爬茅缸	离死（屎）不远
屎壳郎爬在算盘上	混账
屎壳郎排队	奥趣相投；一溜黑货
屎壳郎配花大姐（二十八星瓢虫）	一对臭货
屎壳郎推车	滚蛋
屎壳郎推蛋蛋	滚的滚，爬的爬；连滚带爬
屎壳郎围着驴腚（ding臀部）转	跟屁虫
屎壳郎下蛋	孬（nao坏；不好）种；不是好种
屎壳郎钻炭堆	不显眼
屎壳郎坐飞机	臭气熏天；一步登天
屎壳郎坐轮船	臭名远扬
屎壳螂白脖子	新鲜儿
屎壳螂搬家	不过本份（粪）；走一路，臭一路
屎壳螂掉车辙	不走就撵（碾）
屎壳螂飞到车道沟里	充硬骨头
屎壳螂进花园	不是这里的虫儿
屎壳螂落在粪盆里	过什么大江大海
屎壳螂爬鞭梢	光知道腾云驾雾，不知道死在眼前
屎壳螂爬上花椒树	脚都麻了
屎壳螂爬在算盘上	混帐
屎壳螂爬在炭堆上	不动显不出自己黑
屎壳螂腾空	硬充战斗机
屎壳螂遇到放屁的	空喜一场
屎坑里的皮球	说他臭，他还一肚子气
屎坑里的砖头	又臭又硬
屎坑上搭凉棚	臭架子；摆臭架子
屎盆往脑袋上扣	栽赃（脏）
屎胀了挖茅厕（mao ce厕所）	迫不及待
世界地图吞肚里	胸怀全球
事秆门闩玻璃鼓	经不起推敲
是人都有两只眼	不足为奇
收割了的庄稼地	一溜净光
收鸡毛的挑刺	找毛病来
收了白菜种韭菜	清（青）白传家
收了庄稼到田间	找茬儿
手背上长白毛	老手
手不溜（动作利索）怨袄袖	强词夺理
手不麻利（动作敏捷）怨袄袖	怪物
手长六指头	节外生枝
手长袖子短	顾不上；高攀不上
手里的泥丸	要扁就扁，要圆就圆
手里提个秃镐头	没有把握
手榴弹爆炸	心胆俱裂
手榴弹捣蒜	危险；冒险
手榴弹的尾巴	拽（zhuai 拉）不得
手榴弹冒烟	近不得身；给谁谁不要
手拿算盘串门子	找人算账
手帕包牛脑袋	露头角
手帕做床单	横竖不够料
手捧鸡蛋过河	小心过度（渡）
手捧蒺藜（ji li 一年生草本植物。果皮有尖刺）	碰到棘手事；棘手
手托灯笼上山顶	惟我高明
手心里搭舞台	捧场做戏；捧场
手心里的玻璃球	掌上明珠
手心里的面团	要扁就扁，要圆就圆
手心里的虱子	明摆着
手痒去捅马蜂窝	想惹祸
手掌穿靴子	行不通；走不通
手掌里搁火炭	受不了
手掌上的纹路	明摆着
手掌心放烙铁	自作自受
手指抠伤口	触到了痛处
守着公鸡下蛋	白搭工
守着火炉吃冰棒	冷热结合
寿星出点子	老主意
寿星出虚恭（放屁）	老气
寿星戴风帽	老一套
寿星跌跟头	老得发昏
寿星公唱曲子	老调子；老调
寿星看太医	老毛病
寿星老儿插草标儿（插在欲售之物上表示出卖的草棍儿）	倚老卖老
寿星老儿吃砒霜（pi shuang砷的氧化物。剧毒）	活得不耐烦；活够了
寿星老儿打飞脚	力不能及；力不从心；心有余而力不足
寿星老儿的脑袋	宝贝疙瘩
寿星老儿练琵琶	老生常谈（弹）；老调重弹
寿星老儿骑狗	没路（鹿）
寿星老儿骑仙鹤	无路可走
寿星老儿气喘	老毛病
寿星卖了张果老	倚（以）老卖老
寿星娶小	人老心不老
受潮的米花糖	皮了
瘦驴拉硬屎	瞎逞能
瘦驴拉重载	受不了
瘦牛想吃高山草	力不能及；心有余而力不足
瘦死的骆驼	比马大
瘦子光膀子	露骨
书桌上的笔筒	粗中有细
梳头姑娘吃火腿	游（油）手好闲（咸）
梳妆台上的镜子	明摆着
舒服他娘哭半夜	舒服死啦
输了的赌徒	垂头丧气
输了的象棋	定局了
秫秸（shu jie去穗的高梁秆）秆当门闩	经不住推，也搁不住拉
秫秸秆做柱子	顶不住
秫秫秸（shu shu jie 高梁秆）做栏杆	不牢靠；不可靠
熟螃蟹	横行不了
熟人对面不相识	眼力差
熟透的大枣	自来红
熟透的甘蔗	节节甜
熟透的桑葚	红得发紫
熟透了的瓜	不用摘
熟透了的石榴	合不拢嘴；咧开了嘴
熟透了的柿子	弄了个大红脸
暑天隔夜的猪肉	有气儿
暑天借扇子	不识时务；
暑天下冰雹	一冷一热；忽冷忽热
暑天下大雪	少见；少有
黍米做黄酒	后劲大
蜀绣被面包小人书	话（画）里有话（画）
树林里放风筝	勾勾搭搭；乱缠；缠住了
树上的烂杏	数它坏
树上的乌鸦，圈里的肥猪	一色货
树上的叶子	冷落
树梢上吹喇叭	趾（枝）高气扬
树头乌鸦叫	不入耳；难入耳
树叶掉下来捂脑袋	过分小心
树叶落下怕打破头	胆小鬼
树叶子掉到河里	随波逐流：
树阴底下使罗盘	阴不阴来阳不阳
树枝上挂团鱼	四脚无靠
树枝丫盖房	不是正经材料
树枝做拐杖	光出岔子；净岔子
树桩上的鸟儿	迟早要飞
竖起大拇指当扇子	自夸
数冬瓜道茄子	唠唠叨叨
数九寒天穿裙子	抖起来了
数九寒天一盆火	人人欢喜；个个喜爱
刷子画梧桐	粗枝大叶
刷子没有毛	有扳眼；有扳有眼
耍把式的玩刺渭	扎手
耍把戏的猴子	认人牵着走
耍把戏的玩刺猬	扎手
耍大刀的唱小生	改行了
耍猴的碰上敲锣的	对一点了
耍皮影的手	尽捉弄人
耍皮影的遇路动	丢人
耍皮影子（皮影戏。用兽皮或纸板作成人物剪影来表演故事的戏曲）的	尽捉弄人
耍戏法的敲锣	要变了
摔跟头捡票子	做美梦
摔跤捡金条	喜出望外
甩出去的手榴弹	大发雷火
甩了西瓜捡芝麻	因小失大；避重就轻
甩手掌柜	么事不管；什么事也不管；啥事不管
拴在树上的叫驴	尽绕圈子
拴在桩上的牛犊子	身不由己；不由自主
双胞胎比长相	一模一样；没什么两样；一个样
双车吃士	将军；将了军
双锤落鼓	一个音
双黄蛋	一身二心
双簧戏表演	随声附和；扭捏作态
双脚踏双船	犹豫不定
双目失明的司令	瞎指挥
双色圆珠笔	有二心
双扇门上贴门神	一对儿
双手插进靛缸里	左也难（蓝），右也难（蓝）
双手举碌碡（liu zhou石磙）	力大无穷
双手拍蚂蚱	一下当两下
双手捧鸡蛋	十拿九稳
霜打的高梁苗	抬不起头来
霜打的黄瓜	蔫（nien花木、水果等因失去水分而萎缩）了
霜打的麻叶	垂头丧气
霜打的嫩苗	奄奄一息
霜打的茄子	软不拉耷（da下垂）
霜打茄子	软不拉耷
霜后的蝈蝈	没几天叫头
霜后的萝卜	动（冻）了心
霜后的桑叶	没人睬（采）
谁蒸下馒头等着你	怕冷了不成
水兵的汗衫	道道多
水泊梁山的兄弟	越打越亲热
水池里长草	荒唐（塘）
水池里拾蟹子	十拿九稳
水到屋顶帆到瓦	水涨船高
水道眼贴对子	门头不高
水底捞月，天上摘星	可望而不可即
水底下推船	卖力看不到，成功不叫好
水豆腐沙豆渣	炒个稀巴烂
水缸里按葫芦	松不得手
水缸里的葫芦瓢	沉不下去
水缸里摸鱼	十拿九稳
水沟里的篾片	总有翻身日
水沟里的泥鳅	掀不起大浪；翻不了大浪
水沟里放木排	难回头；回头难
水罐里的王八	瞎碰；瞎撞
水鬼找城隍	恶人先告状
水壶里翻跟头	胡（壶）闹
水壶里扔秤砣	砸啦
水壶里盛汤圆	肚里有货倒不出
水浇石灰船	没有救
水进葫芦	吞吞吐吐
水晶菩萨	神明
水井里放糖精	甜头大家尝
水牢里逃出的囚犯	九死一生；死里求生
水里的鸳鸯	难舍难分；形影相随
水龙头不关	自流
水面砍一刀	无伤痕
水面上的油花	漂浮
水泥柱当顶门杠	大老粗
水泥柱里的钢筋	暗中使劲；使暗劲
水牛踩浆	拖泥带水
水牛踩在稀泥凼（dang水坑）	越弄越糊涂
水牛长毛	彻头彻尾
水牛吃荸荠（bi qi）	食而不知其味
水牛吃活蟹	有力无处使
水牛打架	勾心斗角
水牛的一生	忍辱负重
水牛过河	露头角
水牛见了骆驼	矮了半截子
水牛抓跳蚤	有劲使不上
水牛走到象群里	矮了一头
水泡豆腐渣	轻松
水泡豆子	自我膨胀
水瓢上记账	一概抹销
水上的浮萍	沉不下去；随风飘
水獭（ta）看渔场	越看越光
水獭上山	装熊
水塘里捞芝麻	难得；得之不易
水塘里挖藕	心眼多；心眼不少
水田里的泥鳅	没见过世面
水桶当喇叭	大吹
水桶没梁	饭桶
水桶缺了把	不成体统（提桶）
水推龙王走	自顾不暇；自己顾不了自己
水推菩萨	绝妙（庙）
水瓮里的鳖	跑不了
水仙不开花	装蒜
水淹田园再筑坝	迟了
水银落地	见缝就钻；无孔不入
水中荡葫芦	两边摆
水中的鳄鱼，山上的虎豹	凶的凶，狠的狠
水中捞月	一场空
水中月，镜中花	看得见，摸不着
水煮驴皮胶	难熬
水煮石头	难熬
睡不着，怨床脚	错怪
睡觉不枕枕头	空头空脑
睡懒觉的还要个垫背的	福享尽了
睡梦别扁担	到处横行
睡梦吃蜜糖	想得倒甜
睡梦里抱元宝	财迷心窍；财迷
睡梦里观景致	尽想好事：想得倒美
睡梦坐朝廷	高兴一时是一时；快活一时算一时
顺得姑来失嫂意	难得两全；两头为难
顺风扯满蓬	一帆风顺
顺风顺水船不动	不对头
顺沟摸鱼	没跑；跑不了
顺脚印走路	步人后尘
顺了哥哥失嫂意	两头为难
顺梢吃甘蔗	一节比一节甜
顺手牵羊	趁机行事
顺水人情	不费力；不费劲
顺水推舟，顺风扯篷	见机行事
顺水推舟	不费力；不费劲
顺藤扒地瓜	追根求源
顺藤摸瓜	十拿九稳
顺着梯子下矿井	步步深入
说话捧着乌纱帽	封官许愿
说牛马下蛋	笑话连篇
说起风便扯帆	说干就干
说书的唱大鼓	走了板
说书的落目	替古人担忧
说书的刹板	下回分解
说书的收了三弦琴	不谈（弹）了
说书的走江湖	全凭一张嘴；全仗嘴
说书的嘴，唱戏的腿	有伸有缩（说）
说书的坐板凳	能说不能行
说书人刹板	要钱；且听下回分解
说真方卖假药	冒牌货
说嘴的郎中（中医医生）	无好药；治不了病
丝绸口袋装狗屎	白糟踏
丝绸绣腊梅	锦上添花
丝绳系骆驼	不牢靠；不可靠
丝线缠麻线	越缠越乱
丝线穿珍珠	串起来了
丝线打结巴（结子。条状物打成的疙瘩）	难解难分；解不开
丝线麻线混一团	难缠
丝线拧成一股绳	合在一起千
司号员打鼓	自吹自擂
司机闹情绪	想不开
司令哼曲子	官腔官调
司令上树	趾（枝）高气扬
司马遇文君	一见钟情
司马昭之心	路人皆知
司务长打他爹	公事公办
司务长发军装	一套一套的
司务长买饭票	公私分明；公是公来私是私
撕衣服补裤子	于事无补；因小失大
死得不明不白	糊涂鬼
死后谈功过	盖棺论定
死胡同里赶大车	行不通；走不通；此路不通
死胡同里截驴子	看你往哪钻
死了的啄木鸟	好硬的嘴；嘴硬
死了爹哭妈	混小子
死了耗子猫来哭	假慈悲；假慈善
死了没人抹眼皮	断子绝孙
死了三年的老鸹	光剩嘴
死了孙子哭爷爷	乱了辈分
死了丈人哭爹	随大流
死马当活马骑	痴心妄想；妄想
死牛用刀杀	多此一举
死人穿新鞋	白糟踏
死人堆里的老鼠	眼红；红眼
死人脸上挨耳光	死不要脸
死人欠账	活该
死人下葬	永无出头之日；难出头
死娃娃灌米汤	没法治；没治了
死鱼的眼睛	定了
四川的担担面	又麻又辣
四川的盖碗茶	泡起
四大金刚拿豆鼠子（小老鼠）	大眼瞪小眼
四大金刚扫地	大材小用；有劳大驾
四大金刚讨饭	穷凶极恶
四大金刚腾空	不着实地；悬空八只脚
四大金刚摇船	大摇大摆
四大天王丢盔弃甲	大败而逃
四大天王流涎水（口水）	没出息
四方棒槌	死笨
四方萝卜	愣头青
四方木脑袋	难开窍；不开窍
四方木头	踢一踢，动一动
四个鼻孔烂了仨	一个鼻孔出气
四个菩萨仨猪头	哪有你的份
四个兽医抬只羊	没法治；没治了
四季豆翻花（开二道花）	老来俏
四两花椒炖只鸡	肉麻
四两棉花八张弓	细谈（弹）
四两人讲半斤话	自不量力；不自量
四面八方都有客	朋友遍天下
四扇屏里卷灶王	话（画）里话（画）
四十里地不换肩	抬杠的好手
四月间的桃花	谢了
四肢长胡子	毛手毛脚
四肢抽筋	缩手缩脚
寺里的木鱼	任人敲打；挨敲的货
寺里起火	妙哉（庙灾）；慌了神
松板夹骆驼	两头吃苦
松鼠的尾巴	翘得高
松鼠想吃树上鸟	办不到；没法办
松树林挂灯笼	万绿丛中一点红
宋朝的秦桧，明朝的严嵩	奸对奸
宋徽宗的鹰，赵子昂的马	好活（画）儿
宋江的绰号	及时雨
送亲家接媳妇	两头不误
送丧路上遇旋风	祸不单行
送走客人做饭吃	吝啬鬼
苏木当柴烧	不识货
苏三上公堂	句句真言
苏州的蛤蟆	难缠（南蟾）
苏州老鼠走到杭州偷吃	走也走瘦了
酥油里插刀子	迎刃而解
蒜辫子顶门	头多
蒜地捣葱	离不了辣味
蒜地里栽辣椒	一茬比一茬辣
蒜口子脑袋	没窝没缝
蒜苔（tai）拌藕	对上眼了
蒜苔发杈	二杆子
蒜头疙瘩戴冷帽	装大头鬼
算卦先生的葫芦	肚里有鬼
算卦先生的签袋子	满肚子鬼
算盘珠子	拨拨动动；不拨不动
算盘珠子脱了框	无用
算盘子进位	以一当十
随口唱山歌	心中早有谱
孙大圣的武艺	神通广大；变化多端
孙大圣赴蟠桃园	偷吃偷喝
孙大圣管蟠桃园	监守自盗
孙二娘的裹脚布	又臭又长
孙二娘开店	坑害人；谋财害命
孙猴七十二变	神通广大
孙猴甩掉紧箍咒	无法无天
孙猴子半天云里打眼罩	站得高，看得远，登高望远
孙猴子变戏法	无中生有
孙猴子穿汗衫	半截不像人
孙猴子的脸	说变就变；变化无常；转眼就变
孙猴子的屁股	坐不住；坐不稳
孙猴子的手脚	闲不住
孙猴子的尾巴	变不了；没法变
孙猴子斗魔王	打你个牛角朝天
孙猴子封了个弼（bi）马温	不知自己官大官小；沾沾自喜
孙猴子上了花果山	称王称霸；称心如意
孙猴子上天宫	得意忘形
孙猴子守桃园	自食其果
孙猴子跳出水帘洞	好戏在后头
孙猴子压在五行山下	永世不得翻身
孙猴子坐天下	手忙脚乱；毛手毛脚
孙猴钻进铁扇公主肚子里	心腹之患
孙女穿上奶奶的鞋	钱（前）紧；老样子
孙庞（战国人孙膑和庞涓）斗智	不是你死，就是我亡
孙权嫁妹	赔了夫人又折兵
孙权杀关公	嫁祸于人
孙权招妹夫	弄假成真
孙武训宫女	纪律严明
孙武用兵	以一当十
孙悟空拔猴毛	变化多端；转眼就变；变化无常
孙悟空保唐僧	忠心耿耿；降妖拿怪
孙悟空变魔术	花样多
孙悟空变山神庙	露了尾巴
孙悟空打猪八戒	倒打一耙
孙悟空戴上紧箍咒	无法可使；有法难使
孙悟空当齐天大圣	自封为王；自个儿称王
孙悟空到南天门	慌了神
孙悟空的金箍棒	神通广大；能大能小
孙悟空登上金銮殿	毛手毛脚
孙悟空翻跟头	一步十万八千里；拿手好戏；一步登天；出不了如来佛的手心
孙悟空放屁	猴里猴气
孙悟空赴蟠桃会	不请自到
孙悟空借芭蕉扇	一物降一物
孙悟空进了八卦炉	越练（炼）越结实
孙悟空拿（捉）猪八戒	能人之上有能人
孙悟空七十二变	花样多
孙悟空三打白骨精	降妖拿怪
孙悟空手里的金箍棒	随心所欲
孙悟空跳加官（旧时戏曲开场或演出中，遇到显贵到场时，加演的舞蹈节目）	人面兽心
孙悟空听见紧箍咒	头痛
孙悟空遇到如来佛	无法可使；有法难使
孙悟空照镜子	猴里猴气
孙悟空住在水帘洞	称王称霸
孙行者的毫毛	随机应变
孙子穿爷爷的鞋	老一套
笋壳套牛角	正合适
笋子变竹	越来越高；节节高
隼鸟打猎	帮凶
榫（sun）头钉铁钉	双保险
梭引红线穿绿浅	泾渭（经纬）分明
梭子不挂线	空来往
蓑衣上绣花	底子差；基础差
唢呐里吹出笛子调	想（响）不到一块；想（响）的不一样
他念他的经，我拜我的佛	互不干扰
塌鼻头闻鼻烟	没味道
塌锅干饭	闷（焖）起来了
塌了窝的蚂蚁	阵脚大乱
塔顶散步	走投无路
塔尖上点灯	高明
踏破的皮球	一肚子气（比喻正在生闷气。）
踏在薄冰上	好险；冒险；危险
踏着脖子敲脑壳	欺人太甚；太欺人
台上唱戏，台下打鼾（han）	看不上眼
台上握手，台下踢脚	翻脸不认人；两面派
台子上收锣鼓	没戏唱了
抬棺材的打哈哈	有哭有笑；哭的哭，笑的笑
抬棺材的掉裤子	羞死人
抬轿吹喇叭	光图热闹；凑凑热闹；凑热闹
抬头望鹰，低头抓鸡	眼高手低
抬头只见帽沿，低头只见鞋尖	目光短浅
抬着棺材赴战场	要拼命；拼啦
抬着食盒爬上树	言之（沿枝）有理（礼）
太湖的虾子	白忙（芒）
太极拳的功夫	柔中有刚
太监读圣旨	照本宣科
太监娶媳妇	痴心妄想；妄想
太平洋搬家	翻江倒海
太平洋里下钩子	放长线钓大鱼
太平洋里一滴水	微不足道；微乎其微
太上老君开处方	灵丹妙药
太师椅着了火	坐也难，站也难
太岁当头坐	非灾即祸
太岁头上的土	动不得
太岁头上动土	胆子大；自取其祸；惹祸上身；胆大包天；惹不起；胆子不小
太武帝的口味	不凉不热，不软不硬
太行山上看运河	远水不解近渴
太阳底上点灯	多余
太阳底下的露水	不长久
太阳底下点灯	多余
太阳底下堆雪人	不长久
太阳地里打电筒	多此一举
太阳地里望星星	白日做梦
太阳和月亮讲话	空谈
太阳离了地皮	亮啦
太阳落坡月上山	接连不断
太阳落在脑袋上	大难临头
太阳上面点火	聊天
太阳下面的露水	不久长；难长久
泰山顶上唱大戏	唱高调
泰山顶上观日出	站得高，看得远；登高望远
泰山顶上散步	没奔头
泰山顶上添捧土	无济于事；不济事
贪吃不留种	顾前不顾后；过一天算一天
贪官醉酒	丑态百出
贪婪鬼赴宴	贪吃贪喝；饱吃饱喝
贪食拉肚子	吃了嘴的亏；全坏在嘴上
贪嘴的鱼儿	爱上钩
瘫子摆渡	划不来
瘫子不出门	作（坐）家
瘫子掉进烂泥塘	不能自拔
瘫子掉井里	捞起也是坐
瘫子截路	坐着喊（比喻只动口不动手。）
瘫子请客	坐等
瘫子挑水	担当不起
瘫子遇到贼打劫	坐地呐喊
瘫子捉坏蛋	靠不住
坛子里的豆芽菜	直不起腰；受不完的勾头罪；冤屈（圆曲）
坛子里的皮蛋	变了
坛子里的咸菜	有言（盐）在先
坛子里和面	搭不上手
坛子里喂猪	插不上嘴；难插嘴；一个个来
坛子里掷骰子	没跑（比喻非常有把握。）
坛子里种豆子	扎不下根
坛子里装泥鳅	滑不到哪里去
坛子里捉乌龟	手到擒来
昙花开放	一时谢（比喻好景不长。）
谈判桌上的交易	讨价还价
谈心不点灯	说黑话
潭柘寺（位于北京西郊）的和尚	没数
檀香木当柴烧	不知好歹；不识货
檀香木盖茅厕	香臭难分
檀香木做锅盖	用材不当
檀香木做烧火棍	屈了材料
坦克打冲锋	有股闯劲
炭黑做汤圆	漆黑一团
炭火盆扛肩上	恼（脑）火
炭筛子筛芝麻	全落空
汤罐里饨鸭	突出一张嘴
汤罐煮鸡头	突出一张嘴
汤锅里的小麦	面熟
汤锅里放黄连	有苦大家吃
唐伯虎进宁王府	装疯卖傻
唐伯虎追秋香	千方百计
唐朝的擀面杖	老光棍
唐三藏读佛经	出口成章
唐三藏过火焰山	凶多吉少
唐三藏撞见牛魔王	舌头短截
唐僧的龙马	腾云驾雾
唐僧的心胸	慈悲为怀
唐僧的眼睛	不认识好坏人
唐僧和尚念佛经	一本正经
唐僧念书	一本正经
唐僧跑进和尚店	同吃一碗斋饭
唐僧取经	千辛万苦
唐僧上西天	一心取经
唐僧相信白骨精	人妖不分
唐僧遇见白骨精	敌我不分
唐山的火车	倒霉（煤）
堂前中央挂灯笼	正大光明
堂屋里打酒厨房卖	便宜不出外
堂屋里挂粪桶	臭名在外
堂屋里挂狗皮	那是什么话（画）
堂屋里挂碾盘	实话（石画）
堂屋里挂兽皮	不像话（画）；不成话（画）
棠梨不叫棠梨	杜梨（肚里）
塘里的浮萍	浮在上面
糖炒板栗	熟了就崩（蹦）
糖面做娃娃	适甜人儿
糖捏的人	一吹就化
螳臂挡车	自不量力；不自量
螳螂肚子蛤蟆嘴	瞧你的榜样
螳螂落锅	全身都酥了
螳螂落油锅	全身都酥了；粉身碎骨
躺倒的枯树	腐朽
躺在粪堆上睡觉	不知香臭
躺在功劳簿上睡大觉	沾沾自喜
躺在棺材里想金条	贪心鬼
躺在怀里的猫儿	俯首贴耳
躺着说话	腰不痛
烫了屁股的猴子	急红了眼
烫手的粥盆	扔了心痛，不扔手痛
烫死的鸭子	身子烂了嘴还硬
掏大粪的做知县	臭底子；底子臭
掏耳朵用马勺	小题大做
掏干油罐子煎豆腐	不惜代价；下尽本钱
逃荒的落户	举目无亲
逃难跑到死胡同	绝路一条
桃子掉地上	熟透了
桃子破肚	杀身成仁
陶瓷烧窖	里面燃烧（比喻心内有股热劲儿）
陶工手里的黏土	得心应手
陶器店里卖钵头（b6 tou钵）	一套一套的
讨吃的敬神	穷恭敬
讨吃子（乞丐）过生日	一年不如一年
讨饭的摆酒席	穷排场
讨饭的搬家	光棍；光棍一条
讨饭的打摆子	贫病交迫
讨饭的盖大门楼	阔啦；阔气了
讨饭的拐杖	穷棒子；穷棍
讨饭的捡黄金	喜出望外
讨饭的遇见叫花子（乞丐）	穷对穷；一对穷
讨口的掉醋坛	穷酸
讨口子（乞丐）穿皮袄	穷讲究；穷打扮
讨来的鸡屁股供菩萨	穷恭敬
讨来的馍馍敬祖先	穷孝顺
讨媳妇嫁女儿	一进一出
套裤里伸腿	两岔
套马杆子逮兔子	瞎胡闹
套马杆子戴礼帽	细高挑儿（身材细长的人）
套马杆子顶草帽	奸（尖）的出头
套上大车让老虎架辕	没人敢（赶）
套袖改袜子	没底儿
套着大车卖煎饼	贪（摊）得多
藤长根短	头重脚轻
藤萝爬上葡萄架	纠缠不清
藤攀枯树	乱纠缠
剔光了肉的排骨	没多大油水；油水不大
剔了肉的猪蹄儿	贱骨头
踢寡妇门，挖绝户坟	净干缺德事
提傀儡（木偶戏里的木头人）上戏场	缺少一口气儿
提马灯下矿井	步步深入
提唢呐打瞌睡	做事不当事
提猪头进庙	走错了门；找错了门
提着扁担串门子	直来直去；直出直人
提着尺子满街跑	量人不量己；不量自己，光量别人
提着醋瓶讨饭	穷酸
提着醋瓶要饭	穷酸
提着灯笼打柴	明砍
提着灯笼拾粪	寻死（屎）；找死（屎）
提着灯笼行窃	明日张胆
提着粪杓打猫哩	没枪（腔）
提着影戏（皮影戏）人上场	好歹别戳破
剃胡子不用水	干刮
剃头担子	一厢情愿
剃头刀擦屁股	好险；危险
剃头刀裁纸	真快
剃头刀杀猪	割出来刮
剃头的刀布	要多脏，有多脏
剃头的动手	一触即发
剃头的关门	不理
剃头的管修脚	负责到底
剃头的拿推子	有头了
剃头的拍巴掌	完事
剃头的拍马掌	完事
剃头的收摊	没头了
剃头的头发长，修脚的脚生疮	先人后已
剃头的歇工	没人理
剃头刮脊梁	管得宽
剃头匠的担子	一头冷，一头热
剃头匠发火	置之不理
剃头匠使缝子	一个师傅一外传法
剃头匠说气话	舍得几个脑壳不要
剃头铺关门	不理；没人理
剃头掏耳朵	收拾得干干净净
剃头挑子	一头热；一头冷来一头热
剃头洗脚面	从头错到底
剃头先洗脚	差了一人高
剃头捉虱子	一举两得
天安门前的狮子	一对儿；明摆着
天干禾苗黄	奄奄一息
天高皇帝远	有冤无处申
天黑敬菩萨	心到神知
天花板上挂棋盘	一个子儿也没有
天井里捉鱼虾	没来路
天井院里的瞎子	处处碰壁
天空的浮云	下落不明；一吹就散
天冷偏烤湿柒禾	对着吹吧（比喻互相说大话，或互相吹棒）
天亮才烧炕	晚了；迟了
天亮公鸡叫	白提（啼）
天亮下大雪	明白；明明白白
天灵盖上长眼睛	目中无人
天猫配地狗	一对儿
天牌压地牌	以上压下
天平上称体重	把人看轻了
天平上乱加码子	不公平
天桥的把势	光说不练
天然牛黄	宝贝疙瘩
天山顶上一棵草	有你不多，无你不少
天上彩云	看得见摸不着
天上的彩虹，地下的幻影	看得见，摸不着
天上的彩虹	可望而不可即；好景不长
天上的风筝	一根线在人家手里
天上的浮云，地下的风	无影无踪
天上的星星	数不清；若明若暗
天上的月亮	看得见，摸不着
天上架桥	想到办不到
天上裂了缝	日月难过
天上落豆渣	该猪吃
天上有飞机，地上有坦克	上下夹攻
天生的黄鳝	成不了龙
天生的歪脖子	更改不掉；改不了
天塌了用头顶	假充好汉
天天泡病号	不是好人
天文台上的望远镜	好高鹜远
天要下雨，娘要嫁人	奈何不得；无可奈何；管不着；不由人愿
天要下雨鸟要飞	各随其便
田塍（tian cheng 田埂）边栽洋芋	外行
田塍上种黄豆	靠边站
田埂上的蚕豆	一路
田埂上修茅厕	肥水不落外人田
田埂上修猪圈	肥水不落外人田
田坎上爬长虫（蛇）	地头蛇
田坎上种豆子	一路
田里的蚯蚓	满肚子疑（泥）
田里的庄稼	土生土长
田螺爬到旗杆上	惟我独尊
田鼠走亲戚	土里来，泥里去
田头训子	言传身教
田字倒着写	上下一个样
甜糕蘸（zhan）蒜汁	不对味；不是味儿
甜酒里对水	亲（清）上加亲（清）
挑柴进山	多余
挑打草走路	担空心
挑担的松腰带	没劲儿
挑担子卖豆腐	本钱小，架子大
挑灯草走路	干轻巧活
挑缸钵的断扁担	没有一个好货
挑雷管上山	担风险
挑煤草走路	干轻巧话
挑沙罐下悬崖	家破人亡
挑石头登泰山	谈何容易
挑水带洗菜	一举两得；两得其便
挑水的扁担	长不了
挑水的娶了个卖茶的	正相配
挑水的逃荒	背井离乡
挑水骑单车	武艺高；本领高
挑雪填井	白费劲；枉费功；枉费心
挑盐巴腌海	尽干傻事
挑着扁担进门	横祸（货）
挑着大粪放屁	臭味相投
挑着缸钵走滑路	担风险
挑着棉花过刺笆林	东拉西扯；七勾八扯
挑着棉花过刺林	走一步，挂一点
挑着磨盘背着碾	负担太重
挑子吃瓜子儿	走着嗑
条条小溪流大江	大势所趋
笤帚疙瘩上打茧	结不出好果来
跳大神的翻白眼	没咒念
跳到黄河洗不清	太冤枉；冤枉
跳河闭眼睛	横了心
跳上岸的大虾	慌了手脚；离死不远
跳上舞台凑热闹	逢场作戏
跳网的鱼儿又吞钩	躲了一灾又一灾；祸不单行
跳舞的脚步	有进有退
跳下黄河	洗不清
跳蚤变龙钟	冒牌货
跳蚤充龙种	冒牌货
跳蚤戴串铃	装什么大牲口
跳蚤顶被窝	枉费心机；力不能及；心有余而力不足
跳蚤放屁	小气
跳蚤性子	见肉就叮
贴身的丫鬟	寸步不离
铁板上钉钉	有板有眼；硬对硬；当当响
铁杵磨绣针	非一日之功；功到自然成
铁炊帚刷铁锅	都是硬货
铁锤打到橡皮上	一声不响
铁锤打钢钎	硬对硬
铁锤打夯	层层着实
铁锤打纸鼓	不堪一击
铁锤当炒勺	砸锅
铁锤擂山石	干净利索
铁锤敲钟	响当当；当当响
铁锤砸核桃	粉身碎骨
铁锤砸乌龟	硬碰硬；不怕你硬
铁锤砸西瓜	不好收拾
铁锤子敲钟	响当当
铁打的棒槌	硬邦邦
铁打的肠子铜铸的心	变不了；没法变
铁打的钉耙	一把硬手；是把硬手
铁打的房梁磨绣针	功到自然成
铁打的耕牛	动不得力（犁）（比喻不能用力。有时表示气力不足。有时表示无能为力或有力使不出。）
铁打的葫芦	口难开；不好开口；不开窍；难开窍
铁打的馒头	难啃；啃不动
铁打的锁链	一环套一环；一环扣一环
铁打的围墙	不透风
铁打的衙门，流水的县官	有职不愁无权
铁钉钉黄连	硬往苦里钻
铁钉铆在钢板上	扎扎实实
铁钉耙挠痒	充硬手
铁饭碗	打不破
铁公鸡请客	一毛不拔
铁公鸡身上拔毛	莫想
铁公鸡下蛋	没指望；不可能的事；没有的事
铁公鸡	一毛不拔
铁钩子搔痒痒	是把硬手
铁拐李摆摊	蹩脚货
铁拐李背何仙姑	将就
铁拐李的葫芦	不知卖的啥药
铁拐李的脚杆	长短不齐；高的高来低的低
铁拐李的脚杆子	高低不平（比喻程度不一样）
铁拐李葫芦里的药	医不好自己的病（比喻只看到别人的缺点，看不到自己的毛病。）
铁拐李看月亮	上不正，下参羡
铁拐李落难卖跌打药	总会碰到识货人
铁拐李卖跌打药	货真价实
铁拐李跳舞	摆不平
铁拐李走独木桥	够戗（够受的）；走险
铁拐李走路	一摇三摆
铁棍钓鳖	有个硬杆支着
铁锅里的螺狮	水深火热
铁锅遇着铜炊帚	对头
铁盒里装钉子	有尖不露
铁将军把门	关门闭户；家中无人
铁匠摆手	欠捶（锤）
铁匠被锁	自作自受；自食其果
铁匠拆炉子	散伙（火）
铁匠出身	光会打
铁匠打铁不用锤	好手
铁匠当军师	打上前去；打打打
铁匠的儿子	就知道打打打
铁匠的围腰	漏洞多
铁匠改行学绣花	拈轻怕重
铁匠教徒弟	只讲打；趁热打铁
铁匠开炉	趁热打
铁匠夸徒弟	打得好
铁匠拉风箱	柔能克刚（钢）
铁匠炉的钳子	好家伙（夹火）
铁匠炉里的铁	该打
铁匠骂徒弟	不会打
铁匠卖大饼	不务正业；不干正经事
铁匠牧羊	干的不是那一行
铁匠女儿嫁石匠	硬对硬
铁匠铺的东西	打出来的
铁匠铺的料	挨敲的货
铁匠铺的买卖	件件都是硬货
铁匠铺开门	动手就打
铁匠铺开张	煽（扇）风点火；丁丁当当
铁匠铺里的火叉	一头热
铁匠铺里的家什	都是硬货
铁匠铺卖豆腐	软硬兼施
铁匠上班	不打不行
铁匠生炉子	煽（扇）风点火
铁匠师傅的手艺	丁丁当当
铁匠使凿子	斩钉截铁
铁匠说梦话	快打
铁匠死了不闭眼	欠捶（锤）
铁匠死在宝剑下	自作自受
铁匠无样	边打边相（xiang端详）
铁匠绣花	外行；改行；干的不是那一行
铁匠做买卖	样样过得硬
铁匠做生意	都是硬货
铁壳里放鸡蛋	万无一失
铁拉锁，子母扣	分久必合，合久必分
铁笼捕鼠	捉活的
铁笼子里的老虎	威风扫地
铁路警察摆手	管不着那一段
铁路警察	各管一段
铁路上的车站	靠边站
铁路上的枕木	经得住压；明摆着
铁牛的屁股	推不动
铁耙搔痒痒	是把硬手
铁耙子挠头	一把硬手；是把硬手
铁耙子抓痒痒	小题大作；充硬手
铁皮葫芦	外强中干
铁球掉在江心里	团圆到底
铁人不怕棍	身子硬
铁人带钢帽	双保险
铁人遭棍打	不屈不挠
铁勺子烙饼	供不上嘴
铁树开花，哑巴说话	难遇
铁树开花	千载难逢；无结果；好事难盼
铁刷子抓痒	道道多
铁丝串铜铃	两头溜
铁丝做门闩	经不起推敲
铁桶里放鞭炮	空想（响）
铁砣掉井里	不懂（扑通）
铁铸黄牛	开不得犁
铁爪捉木鸡	手到擒来
铁嘴豆腐脚	能说不能行
厅堂里的老古董	摆设
听鼓书抹眼泪	有情人
听见猫叫骨子酥	胆小如鼠
听见猫叫身子抖	胆小如鼠
听评书流泪	替古人担忧
听哑巴唱戏	莫名其妙
亭子里聊天	讲风凉话
亭子里谈心	讲风凉话
通火棍当枪使	打不响
通州集	常事（市）
同床异梦	有二心
同吹两把号	想（响）到一块了
同窑烧的砖瓦	一路货
同一个马鞍上的人	走的是一个方向
同一只鞋楦（xuan）的鞋	一模一样；没什么两样
桐油畚斗（ben dou簸箕）	滴水不漏；点滴不漏
铜叉碰铜锣	想（响）到一快了
铜匠的家当	各有一套
铜铃打鼓	另有音
铜罗汉铁金刚	一个比一个壮；一个赛一个
铜罗汉铁金铡	一个赛一个
铜盘碰上铁扫帚	互不相让；谁也不让谁
铜盆撞了铁扫帚	谁也不让谁
铜钱当眼睛	认钱不认人
铜钱眼镜	认钱不认人；一切向钱看
铜钱眼里打秋千	小人
铜墙铁壁	坚不可摧
铜铸的仙鹤	翅膀再硬也飞不起来
童男童女（旧时殉葬用的纸男纸女）跌河里	架子不倒
童荞媳侍候公婆	小心在意
童养媳当媒人	自顾不暇；自身难保
童养媳当婆婆	慢慢熬
童养媳哭老公（丈夫）	有苦难诉；有苦说不出
童养媳拿钥匙	做不了主
童养媳伺候公婆	小心在意
童子带路	以小引大
瞳孔里挑刺	故意找茬（碴）儿
捅开的锈锁	开窍了
捅烂大脚充疮	无事生非
桶水两盐	淡而无味
桶作喇叭床当鼓	大吹大擂
筒车（灌溉用的水车）打水	团团转
痛快妈哭痛快	痛快死了
偷吃的猫儿	记吃不记打
偷吃海椒（辣椒）	里外发烧
偷鸡不成蚀把米	不合算；得不偿失
偷鸡打店主	一错再错
偷来的喇叭	吹不得；别吹了
偷来的锣鼓	打不得；想（响）不得
偷南瓜带摘葫芦	两不耽误；两得其便
偷油的耗子	油嘴滑舌
偷嘴的狗儿	见人就逃
头长疔疮，脚烂趾头	两头不落一头
头穿袜子脚戴帽	一切颠倒
头戴背篓进城隍庙	想充大头鬼
头当斗笠，背当蓑衣	自欺欺人；自己哄自己
头顶橄榄核，脚踩西瓜皮	又奸（尖）又猾
头顶轿子	抬举人
头顶上长眼睛	目空一切；旁若无人
头顶生目，脚下长手	眼高手低
头发打摆子	毛病
头发纺纱	不合股；合不了股
头发胡子一把抓	理不清
头发里找粉刺	吹毛求疵（刺）
头发捻绳子	合不了股
头发上擦火柴	划不着
头发丝穿豆腐	没法提；提不起来；别提了
头发丝吊大钟	千钧一发
头发丝儿打结	难解难分；难分难解
头发丝上刻仕女图	人细人微
头上安电风扇	大出风头
头上插草标（插在欲售之物上表示出卖的草棍儿）	自卖自身
头上插辣椒	红到顶了
头上插扇子	大出风头
头上长疮，脚底流脓	坏透了；没治了
头上长疮	顶坏
头上长疙瘩	额外负担
头上长犄角	比别人出格
头上长嘴	说天话
头上穿套裤	上不上，下不下；放不下脸；脸面上下不来
头上穿袜子	弄出脚来了
头上点灯	惟我高明
头上顶灯笼	自作高明
头上顶碓窝（dui wo石臼）	老实（石）疙瘩
头上害疮	顶坏；坏到顶了
头上砍一刀	伤脑筋
头上撒虮子（ji zi虱子的卵）	自讨麻烦
头上生疮	顶坏
头上刷浆糊	糊涂到顶
头上站鸭子	顶呱呱
头上着火	不救自危
头上着人	不救自危
头痛往脊梁上贴膏药	找错了地方；搞错了地方
头痛医脚	不对路数
头痛医头，脚痛医脚	将就着过
头雁中弹	乱了群
头枕元宝	守财奴
投石下河	探探深浅；试探深浅
透过窗缝看落日	一线希（西）望
秃妮子戴花	前不是，后不是
秃山上的猴子	没啥耍了
秃头上顶橄榄	不牢靠
秃头上照电灯	光对光
秃尾巴驴	有头无尾；后梢里虚；抓不住
秃子不要笑和尚	脱了帽子都一样。
秃子出家	将就材料
秃子打赤脚	两头光
秃子打伞	无法（发）无天
秃子戴斗笠	无法（发）五天
秃子当和尚	正好；两将就，两凑合；将就材料；再合适不过了
秃子当皇上	不要王法（发）
秃子的脑袋	一溜净光；精光
秃子的头发	稀稀拉拉
秃子的头皮	不毛之地
秃子顶上的疤	明摆着
秃子跟前，讲理发	惹人放心
秃子跟着月亮走	借光
秃子捡梳子	没用处；无用；没得用
秃子脚上生疮	两头不落一头
秃子摸头皮	无法（发）
秃子脑袋当玩具	耍滑头
秃子头上插花	调（挑）皮
秃子头上的虱子	藏不住；明摆着
秃子头上抹油	滑头滑脑
秃子头上盘辫子	白忙活；白忙一场
秃子演戏	大家观光
秃子照镜子	光对光
秃子争木梳	多余
秃子揍和尚	明打明；光打光
图书馆的耗子	蚀（食）本
图书馆的家当	尽是输（书）
图书馆失火	自然（字燃）
徒手打老虎	有勇无谋
涂金粉伸长舍	装神弄鬼
屠夫家里的肥猪	早晚得杀
屠夫杀鸡	难不住
屠夫杀羊	内行
屠夫说猪，农夫说谷	三句话不离本行
屠夫送礼	提心吊胆
屠夫挑内脏	两头担心
屠户的账本	血债累累
屠宰场的猪	任人宰割
土蚕钻进花生壳里	假充好人（仁）
土地公和土地婆	孤寡一对
土地喊城隍	神乎（呼）其神
土地老打玉皇	犯上作乱
土地老买弹弓	玩心不退
土地老升参谋	诡（鬼）计多端
土地老腾空	神气（起）来了
土地老下池塘	软瘫子；软作一堆
土地庙的横批	有求必应
土地庙里的菩萨	没见过大香火
土地庙上开窗	神气通天
土地奶奶戴花	老来俏
土地奶奶放屁	好神气
土地奶奶跟王母娘娘比美	天地之别
土地奶奶和玉皇爷结婚	远亲
土地奶奶坐月子	养神
土地女儿嫁玉皇	一步登天
土地堂里填窟窿	不妙（补庙）
土地爷搬家	走了神
土地爷被虫蛀了	自身难保
土地爷打城隍	管得宽
土地爷打算盘	神机妙算
土地爷的胳膊	麻缠（胡搅蛮缠）
土地爷的蜡台	一对儿
土地爷跟城隍打架	神鬼不安
土地爷管龙王	以上压下
土地爷开银行	钱能通神
土地爷啃地瓜	窝囊神
土地爷理发	鬼头鬼脑
土地爷拿邪	神出鬼没
土地爷拍蚂蚱	慌了神
土地爷逃难	慌了神
土地爷洗脸	失{湿）面子
土地爷捉迷藏	神出鬼没
土地爷坐班房（监狱或拘留所的俗称）	劳（牢）神
土地爷坐深山	没香火
土豆下山	滚蛋
土匪骑疯狗	恶人凶马
土岗子上闹旱灾	山穷水尽
土里埋金	有内才（财）
土瞎子看告示	装模做样
土杏仁伴黄瓜	苦上加苦
土做的人儿	实心眼
吐口唾沫砸个坑	出口有分量
吐鲁番的葡萄	甜透了
吐着耳朵擤（xlng）鼻涕	不对路数
吐着胡子打滴溜（抓住高处物体，使身体悬空）	嘴上功夫；全凭嘴劲
兔儿头，老鼠尾	不伦不类
兔儿爷（兔头人身的泥塑玩具）打架	散摊了
兔儿爷打架	散摊子
兔儿爷过河	软瘫了
兔儿爷拍胸口	没心没肝
兔死狐悲	物伤其类
兔死还要跳三跳	垂死挣扎
兔子扒窝	安家落户
兔子蹦到车辕上	假充大把势（车把势。赶大车的人）
兔子逼急了	还会咬人哩
兔子剥皮	倒扒
兔子成精	比老虎还厉害
兔子吃年糕	闷了口
兔子打架	小打小闹；上蹿下跳
兔子戴夹板	充大耳朵驴
兔子当牛使	乱套了
兔子的耳朵	灵得很
兔子逗老鹰	惹祸上身；自取其祸；没事找事
兔子跟着马儿跑	望尘莫及
兔子构厥子	没后劲
兔子驾辕	不合套
兔子驾辕马拉车	乱了套
兔子驾辕牛打套	乱了套；乱套了
兔子见了鹰	毛了
兔子叫门	送上门的肉
兔子进磨道	充什么大耳朵驴
兔子靠腿狼靠牙	各有各的谋生法
兔子拉车	不懂那一套；又蹦又跳；连蹦带跳
兔子拉犁耙	力不能及；心有余而力不足；无能为力
兔子满山跑	还来归旧窝
兔子跑到磨坊里	假充大尾巴驴
兔子群里一只虎	庞然大物
兔子生耗子	一窝不如一窝
兔子尾巴	长不了
兔子下儿	与众不同
兔子宴请老虎	寅吃卯粮
兔子枕着猎枪睡	胆大包天
兔子坐上虎皮椅	六神无主
推车爬坡	越高越难
推开窗户	说亮话
推人下井还要滚石头	害人不浅
推土机进茅草地	斩草除根
推小车扭屁股	身不由己；不由自主
推小车上台阶	步步有坎；一步一个坎
推着车子上墙	白费功夫；枉费功
腿肚子搽粉	过份讲究
腿肚子抽筋	身不由己；寸步难行
腿肚子上贴门神	人走家搬
腿肚子上捅一刀	离心远着哪；离心远哩
腿瘸头歪屁股肿	不是好人
腿上绑轮子	跑得快
腿上绑绳子	拉倒
腿上的牛皮癣	顽固不化
腿上挂铃铛	走到哪，响到哪
腿上贴邮票	走人了
退潮的海滩	水落石出
吞金自杀	人财两空
吞了擀面杖	直肠子
吞了烟袋油的蛇	离死不远
托着扁担过马路	横行霸道
托着手鼓提着竹笛	又吹又拍；吹吹拍拍
拖车拉泰山	大头在后面；大的在后头
拖拉机爆胎	好大的气
拖拉机加油	来劲了
拖拉机犁大田	直来直去
拖拉机转弯	卷土重来
脱把锄头	没用处
脱钩的鲤鱼	不再上当
脱钩黄鳝漏网鱼	难兄难弟
脱祸求财	时来运转
脱缰的野马	抓不住；横冲直撞；无拘无束
脱裤子打老虎	既不要脸，又不要命
脱裤子放屁	多一道手续；多此一举
脱了把的斧头	无用
脱了轨的火车	翻了
脱了旧鞋换新鞋	改邪（鞋）归正
脱了裤子打老虎	又不要脸，又不要命
脱了裤子打扇	卖弄风流
脱了鳞的黄花鱼	不知死活
脱了鳞的黄鱼	一天比一天难过
脱了鳞的鱼	一天比一天难过
脱了毛的凤凰	不如鸡
脱了毛的刷子	有板眼；有板有眼
脱了绳的猴子	无拘有束
脱了线的气球	无牵无挂
脱毛的凤凰	不值钱
脱手的气球	无牵无挂；无牵挂
脱下毡帽补烂鞋	顾了这头丢那头
脱衣服烤火	多此一举；弄颠倒了
陀螺屁股	坐不住；坐不稳；立场不稳
驼背上山	不敢回头
驼子跛子睡一床	七拱八翘
驼子穿背心	遮不了丑
驼子打伞	背时（湿）
驼子捡针	伸手就是
驼子仰面睡	两头不着实
驼子作揖	出手不高；起手不难；顺便
鸵鸟钻沙堆	顾头不顾尾；藏头露尾
唾沫粘知了	办不到；没法办
娃儿的脸	一日三变
娃儿斗狗	回头一口
娃儿见了娘	笑逐颜开；喜笑颜开
娃儿哭了给娘抱	一推了事
娃娃摆积木	不成重来
娃娃背磨盘	加重负担
娃娃吃甘蔗	尝到甜头
娃娃吃面条	瞎抓
娃娃吃糖瓜	煳嘴
娃娃穿道袍	宽大无边
娃娃吹喇叭	小气
娃娃吹泡泡糖	口气不大
娃娃当家	啥事不懂
娃娃当司令	小人得志
娃娃荡秋千	两边摆
娃娃掉到糨糊盆里	糊涂人
娃娃掉到阴沟里	臭人
娃娃逗妹妹	嘻嘻哈哈
娃娃放风筝	抖起来了
娃娃放炮仗（爆竹）	又惊又喜
娃娃赶场	东张西望
娃娃供神佛	你哄我，我哄你
娃娃过年	真快活；不操心；光图吃；只讲吃；蹦得欢
娃娃嚼泡泡糖	吞吞吐吐
娃娃看飞机	人小见识高
娃娃看魔术	莫明其妙
娃娃看戏	欢天喜地
娃娃拿到新玩具	爱不释手
娃娃爬楼梯	上下两难；上下为难。
娃娃上街	哪里热闹到哪里
娃娃上了飞机	欢跃欲飞
娃娃拾花炮	沾沾自喜
娃娃耍刺猬	抱着嫌扎手，丢又舍不得
娃娃贴对子（对联）	上下不分；不分上下；倒贴
娃娃推平头	一扫光
娃娃玩肥皂泡	吹起来了
娃娃玩火	万万不可
娃娃玩陀螺	原地打转
娃娃下棋	胸无全局
娃娃学走路	左右摇摆；摇摆不定；一步步来
娃娃鱼的嘴	好吃
娃娃鱼爬上树	不算人
挖耳勺打酒	不是正经东西
挖耳勺里炒黄豆	一个个来
挖耳勺刨地	小抠
挖耳勺舀海水	不显眼
挖耳勺舀米汤	无济于事
挖好肉补烂疮	犯不着
挖井碰见喷泉	好极了；好得很
挖井碰上自流泉	正合心意（比喻正符合自己的想法。）
挖了眼当判官	瞎到底了
挖人墙脚补自己缺口	尽干缺德事
挖肉补疮	得不偿失
挖肉补脸蛋	忍痛图好看
挖塘甩泥鳅	一举两得
瓦背上的胡椒	两边滚
瓦房顶上盖草席	多此一举
瓦房上盖蒿草	怪物（屋）
瓦缸盆倒胡桃	一干二净
瓦罐里点灯	心里亮，肚里明
瓦罐里冒烟	土里土气；土气本
瓦匠干活	拖泥带水
瓦匠碰上鞋匠	帮不上忙
瓦匠砌墙	两面三刀
瓦片凿洞	捅漏子
瓦上结霜	不久长；难长久
瓦石榴	看得吃不得
袜筒改护腕	将就材料
袜子当帽子	臭出头了
袜子改长裤	高升
歪脖子出征	扭头就走
歪脖子挂项链	不见得美
歪脖子看表	观点不正（比喻没有一个正确的看法。）
歪脖子看戏	斜眼瞧人
歪脖子树上结歪梨	不成正果
歪脖子树	值（直）不得；成不了材；根子不正；难治（直）
歪脖子说话	嘴不对心
歪戴帽子歪穿袄	不成体统
歪戴帽子斜穿袄	不成体统
歪锅配扁灶	一套配一套；两将就
歪苗长歪树	根骨不正
歪墙开旁门	邪（斜）门
歪上轴承斜上轴	没安好心
歪头看戏怪台斜	无理取闹
歪歪嘴跌跤	上错下错；错上错下
歪嘴吃螺蛳	以歪就歪
歪嘴吃石榴	尽出歪点子
歪嘴吹灯	风气不正；一团邪（斜）气
歪嘴吹笛子	对不上眼
歪嘴吹海螺	歪对歪；两凑合
歪嘴吹号	正气不足，邪（斜）气有余
歪嘴吹喇叭	一股邪（斜）气
歪嘴戴口罩	看不出毛病
歪嘴当兵	马上丢人
歪嘴当骑兵	马上丢丑
歪嘴和尚	没正经
歪嘴和尚吃螺蛳	以歪就歪
歪嘴和尚吹灯	一股斜气
歪嘴和尚念经	说不出一句正经话
歪嘴讲故事	邪（斜）说
歪嘴佬吹喇叭	调子不正
歪嘴骡子卖个驴价钱	吃了嘴的亏
歪嘴婆娘跌跤	上错下也错
歪嘴婆婆喝汤	左喝右喝
歪嘴照镜子	不知自丑
外公死儿	没救（舅）
外贸商品不合格	难出口
外面得了一块板，屋里丢了双扇门	得不偿失
外婆待外甥	诚心实意
外婆得了个小儿子	有救（舅）了
外婆死了儿	没救（舅）；没有救（舅）
外甥不在家	有救（舅）
外甥打阿舅	公事公办（比喻不存私心，该怎么办就怎么办。）
外甥打灯笼	照旧（舅）
外甥打舅	公事公办；情理难容
外甥赴外公的宴	不客气
外甥披孝	无救（舅）
外甥找到姥姥家	有救（舅）
外头拾块铺衬，屋里丢件皮袄	得不偿失
外屋里的灶王爷	独座儿
外乡人过河	心里没底；不知深浅
外行人看魔术	莫明其妙
弯扁担吹火	一窍不通
弯扁担打蛇	两头不着实
弯刀遇见瓢切菜	正合适
弯藤结歪瓜	孬（nao 坏；不好）种；不是好种
弯腰拾稻草	轻而易举
剜草的拾了个南瓜	捡着大个的
剜了眼的判官	瞎鬼
完秆子顶石磙	头重脚轻
玩把势的绝技	耍花招
玩把戏的作揖	没咒念了
玩猴的丢了锣	耍不起来
玩猴的耍狐狸	不害臊；不知臊
玩火烧自身	自作自受
玩具店里的洋娃娃	讨人爱；有口无心；小手小脚
玩龙船的攀了个打花鼓的	穷对穷；一对穷
玩木偶的不出场	幕后操纵
玩木偶拉绳子	幕后操纵
玩狮舞戴道具	改头换面
玩戏法的丢了猴子	耍不起来
玩着滚轮打主意	想转了
宛平县的知县	管得宽
晚点的火车	赶得上
晚期肺结核	空空洞洞
晚上干活	披星戴月
晚上赶集	散了
碗边上的苍蝇	混饭吃
碗碴子（小碎块）剃头	难受
碗橱里打老鼠	难下手；碍手碍脚
碗底朝天	空空如也
碗底的豆子	历历（粒粒）在目
万花筒	千变万化
万顷黄沙一棵草	不显眼
万岁爷的茅侧	没有你的份（粪）
万岁爷的顺民	安分守己
万岁爷掉进井里	不敢劳（捞）驾；劳（捞）驾不起
万岁爷掉在井里	不敢劳（捞）你的大驾
万岁爷卖包子	御驾亲征（蒸）
万岁爷剃头	不要王法（发）
万丈悬崖上的鲜花	没人睬（采）
万丈悬崖上的鲜桃	没人睬（采）；没人尝过
亡羊补牢	为期不晚
王安石画圆圈	留下一个尾巴
王八背着两面鼓	人前一面，人后一面
王八吃鞭炮	憋气又窝火
王八吃秤砣	铁了心
王八吃柳条	满肚子瞎编；嘴能编
王八吃西瓜	滚的滚；爬的爬；连滚带爬
王八的脖子	能伸：能缩；缩回去了
王八的屁股	规定（龟腚）
王八肚上插鸡毛	龟（归）心似箭
王八肚子上插鸡毛	归（龟）心似箭
王八盖上插蜡扦	鬼（龟）火直冒
王八敬神	摆不上桌；上不了台盘
王八看绿豆	对土眼了
王八扛叉	自觉有光
王八嗑瓜	子当吃香
王八卖笊篱（zhao li 打捞取东西的用具。）	鳖编的
王八爬门槛	只看这一跌
王八上岸遇雹子	缩头缩脑
王八笑乌龟	彼此彼此；彼此一样
王八心肠	直肠直肚；装不住啥
王八咬手指	死不松口
王八遭棍打	缩头缩脑
王八照镜子	鳖形
王八钻鼠洞	大概（盖）难办
王八钻灶炕	憋气又窝火
王八作报告	憋（鳖>声憋（鳖）气
王八坐月子	完（玩）蛋
王宝铡爱上叫化子	有远见
王道士画符	自己明白
王二麻子挨打	敲到点子上
王二麻子当军师	点子多
王府的差役	难当
王府的管家，相府的丫鬟	当家不做主；有职无权
王府的管家	欺上瞒下
王府的丫鬟	低三下四
王魁负桂英	忘恩负义
王老道求雨	早晚在今年
王老二卖瓜	自卖自夸
王麻子吃核桃	里外出点子
王麻子的剪刀	名牌货；货真价实；名不虚传
王麻子中牛痘	悔之莫及；后悔已晚
王母娘的蟠桃	再好也吃不到
王母娘娘得子	天下喜事
王母娘娘的棒槌石	经过大阵势
王母娘娘缝花袄	神聊（缭）
王母娘娘开蟠桃会	聚精会神
王母娘娘伸手	要风得风，要雨得雨
王母娘娘走亲戚	腾云驾雾
王奶奶和玉奶奶	差一点；只差一点儿
王胖子的裤腰带	稀松平常（长）
王婆坏了磨	没法推；推不得
王婆卖瓜	旁人不夸自己夸；自卖自夸
王婆照应武大郎	没好事；不是好事
王七的兄弟	王八
王悄斗石崇	甘拜下风
王熙风管家	大有大的难处
王熙风弄权	聪明反被聪明误
王熙凤的为人	两面三刀
王羲之的字帖	别具一格
王羲之写字	人木三分；熟手
王瞎子看告示	装模作样
王先生和玉先生	只差一点
王小二过年	一年不如一年
王小二开饭店	看人下菜
王小二卖瓜	自卖自夸
王小二敲锣打鼓	穷得叮当响
王小二敲锣	穷得丁当响
王爷的奴才	听差的；百依百顺；低三下四
王爷的宅院	层层深入
王佐断臂	留一手；苦肉计
网包里的田鸡（青蛙）	瞎碰；瞎撞
网袋捞泥鳅	跑的跑，溜的溜
网兜打水	一场空
网兜装猪娃	露了蹄
网里的鱼，笼中的鸟	没跑；跑不了
网里的鱼虾	一个也溜不掉
网中抓鱼	笃定
往瘸子腿上踢	不近人情
往头上拉屎	成心糟踏人
往袜子上钉鞋掌	找错了地方；搞错了地方
望风扑影	一场空（比喻毫无所得。）
望江亭上度中秋	近水楼台先得月
望乡台上掉眼泪	死得好苦
望乡台上看牡丹	做鬼也风流
望乡台上抢元宝	贪心鬼
望乡台上戏牡丹	死风流；做鬼也风流
望远镜观天	一孔之见
望远镜看风景	近在眼前
望远镜照太平洋	一望无涯
巍巍大山	永不动摇
为打耗子伤玉瓶	因小失大
为灭虱子烧棉袄	因小失大；小题大做
为妻骂妾	迫不得已
为人作嫁	徒劳无功；徒劳无益
围棋盘里下象棋	不对路数
围棋盘内下象棋	不对路数
围着火炉吃冰糕	不知冷热
围着火炉吃西瓜	心上甜丝丝，身上暖烘烘
围着叫花子（乞丐）逗乐	拿穷人开心
围着叫化子逗乐	拿穷人开心
桅杆顶上吹唢呐	四方闻名（鸣）
桅杆顶上的海螺	靠天吃饭
桅杆顶上挂鱼肉	空张罗
桅杆顶上看人	把人看矮了
桅杆顶上耍把戏	爬得高，跌得重；武艺高
桅杆尖上的猴子	到顶了
桅杆开花	没指望
桅杆上的螺狮	靠天吃饭
桅杆上吊布袋	装疯（风）
桅杆上响喇叭	高调
桅杆做了顶门杠	大材小用
维吾尔族的朵帕	顶好
维吾尔族的姑娘	辫子多
维吾尔族姑娘的辫子	一抓就是一把
尾巴上绑芦花	冒充大公鸡
苇塘里掰植子	撂倒在地
卫生口罩	嘴上一套
未草里头藏龙身	农家出英才（比喻在平凡的地方或平凡的工作中出现了有才能的人。）
未婚妻做了望门寡	冤枉；太冤枉
喂兔养羊	本小利长
温火爆牛肉	慢工夫
温泉里洗澡	冷暖自己知
温室里的花朵	经不起风雨；经不起风吹雨打
温室里种庄稼	旱涝保收
温水烩饼子	皮热心凉
温水烫鸡毛	难扯
温水煮板栗	半生不熟
温汤里煮鳖	不死不活
瘟神下界	百姓遭难；四方遭灾
文火炖蹄�o（ti pang肘子）	慢慢来
文火煎鱼	慢慢来
文火蒸糕	闷（焖）起来了
文盲读《圣经》	两眼墨黑
文盲贴对子（对联）	不分上下；上下不分
文庙里卖《四书》	冒充圣人
文武大臣见皇上	三拜九叩
闻鼻烟蘸唾沫	假行家
闻着棺材唤儿香	死到临头
蚊虫遭扇打	吃了嘴的亏；全坏在嘴上
蚊龙翻大海	四方遭灾；百姓遭难
蚊龙造反	翻江倒海
蚊子挨人打	全怪那张嘴
蚊子唱小曲儿	要叮人
蚊子打哈欠	好大的口气
蚊子的力气	大不了
蚊子叮观音	看错了人；认错了人
蚊子叮鸡蛋	无孔不入；无缝可钻
蚊子叮泥像	没有人味
蚊子叮菩萨	不识相；找错了人
蚊子肚里找肝胆	故意刁难；有意为难
蚊子放屁	小气
蚊子飞到电灯上	弃暗投明
蚊子飞过能认公母	好眼力
蚊子含秤陀	嘴劲
蚊子趴在玻璃上	插不上嘴；难插嘴
蚊子头上长疮	没多少脓水
蚊子衔秤砣	好大的口气
蚊子咬秤砣	好硬的嘴
蚊子咬木偶	找错了对象
蚊子遭扇打	坏在嘴上
蚊子找蜘蛛	自投罗网
问客杀鸡	虚情假意
瓮中鳖，盘中鱼	没跑；跑不了
瓮中的王八	跑不了
瓮中的乌龟	处处碰壁
莴笋炒蒜苗	亲（青）上加亲（青）
窝里的马蜂	不是好惹的
窝里的蛇	不知长短
窝里的小鸟	迟早要飞走
窝窝头进贡	穷尽忠
窝窝头没眼儿	找着挨抠
窝窝头上坟	哄鬼；骗鬼；哄死人
窝窝头上蒸笼	盖了帽了
蜗牛的房子	背在身上
蜗牛赴宴	不速之客
蜗牛壳里睡觉	难翻身
蜗牛爬上葡萄架	光想高味
蜗牛赛跑	慢慢爬
蜗牛走路	慢腾腾
我解缆绳你推船	顺水人情
我心似你心	心心相印
握着棒槌当萝卜	不识货
握着蒺藜（ji li 一年生草本植物。果皮有尖刺）死不丢	不怕扎手
握着铁锹当锅使	穷极了
乌龟拜年	规规矩矩（鞠鞠）
乌龟变黄鳝	解甲归田
乌龟吃王八	六亲不认
乌龟吃乌贼（墨鱼）	黑心王八
乌龟吃萤火虫	心里亮；肚里明
乌龟打架	硬碰硬
乌龟的后代	龟儿子：
乌龟的脑壳	伸伸缩缩
乌龟垫床脚	硬撑；硬顶
乌龟掉缸里	跌跌爬爬
乌龟跌灰堆	憋气又窝火
乌龟肚子朝天	动弹不得
乌龟翻跟斗	窝脖
乌龟和王八	一模一样，一个样；没什么两样
乌龟进沙锅	丢盔卸甲
乌龟看天	伸伸缩缩
乌龟壳上贴广告	牌子硬
乌龟壳上找毛	枉费功；白费劲；白费功夫：
乌龟拉车	没后劲
乌龟落秤盘	自称自
乌龟买鳖价	不上算；不合算
乌龟撵（nian迫赶）兔子	赶不上；撵不上
乌龟爬门槛	就看此乙遭；早晚要栽跟头
乌龟爬旗杆	想高升
乌龟爬沙	慢慢来
乌龟爬树	上不去，无能为力
乌龟碰壁	得缩头时且缩头
乌龟请客	尽是王八
乌龟摔在石板上	碰上硬的了
乌龟腿上绑老鹰	想飞飞不了，想爬爬不动
乌龟吞煤球	黑心王八
乌龟驮西瓜	滚的滚，爬的爬
乌龟想骑凤凰背	痴心妄想
乌龟笑王八	一个样；彼此一样
乌龟咬王八	自家人不识自家人；一家人不，识二家人
乌龟遭棒打	缩头缩脑
乌龟找甲鱼	一路货色（比喻彼此一样。）
乌江岸上困霸王	四面楚歌
乌拉草（wu la cao 多年生草本植物。茎和叶晒干后垫在鞋或靴子里可以保暖）搀鸡毛	乱糟糟
乌拉草炒韭菜	乱七八糟
乌拉草成名	称宝不在贵贱
乌梢蛇打店	常（长）客
乌鸦扮孔雀	不伦不类
乌鸦不叫乌鸦	太平鸟
乌鸦长白毛	怪事一桩
乌鸦唱山歌	不堪入耳
乌鸦当头过	非灾即祸
乌鸦的下水（内脏）	黑心；黑了心
乌鸦叮蚌壳	脱不了爪爪
乌鸦落房头	开口是祸
乌鸦落在雪堆上	黑白分明
乌鸦笑猪黑	光看别人黑，不见自己黑；不知自丑；彼此彼此
乌鸦一字飞	一溜黑货
乌贼（墨鱼）吐墨	蒙混人
污水坑里的蛆虫	臭货；肮脏货
污水坑里竖旗杆	臭光棍
污水塘里泡豆芽	变味了
巫婆扮凶神	又丑又恶
巫婆打把势	装神弄鬼
巫婆改行	没人信
巫婆和鬼打架	病人跟着受难
巫婆扛锄头	装模作样；装样子
巫婆跳神	鬼花招
巫婆下神	装神弄鬼
巫师的行当	做人又做鬼
巫师转行	改恶从善
屋顶落魔鬼	祸从天降
屋顶上戳窟窿	捅漏子
屋顶上的王八	上不着天，下不着地
屋脊上蹲个猫	活受（兽）
屋脊上放西瓜	两边滚
屋脊上贴告示	天知道；天晓得
屋里翻跟头	里手
屋里放风筝	高也有限
屋里筑篱笆	一家分两家
屋门口的穿衣镜	正大光明
屋檐边的水	点滴不离窝
屋檐上挂马桶	臭名在外
屋檐下的冰凌	根子在上头
屋檐下的大葱	心不死；叶烂皮干心不死
屋檐下的麻雀	经不起风吹雨打
屋檐下吊石滚	严（檐）重
屋檐下躲雨	暂避一时；不长久
屋檐下挂猪胆	苦水滴滴
无边的大海	不知深浅
无病吃药	自讨苦吃
无病呻吟	装模作样；装样子
无底洞	深不可测
无舵的船	随波逐流
无二爷（无常鬼）卖布	鬼扯
无风不起浪	事出有因
无风下双锚	稳稳当当
无根的浮萍	漂浮不定；成不了材
无根的水草	漂浮不定
无花的蔷薇	浑身是刺；只有刺儿
无家可归的流浪汉	东游西荡
无赖打路人	无理取闹
无米之炊	难做
无米子（花生仁）的花生壳	肚里空
无蜜的蜂房	空空洞洞
无牛狗拉车	将就凑合
无牛捉了马耕田	大材小用
无事钻烟囱	自己给自己抹黑
无头的苍蝇	瞎碰；瞎撞
无头的乱麻	一团糟
无王的蜜蜂	乱了群
无弦的琵琶	谈（弹）不得；一丝不挂
无罪戴枷扳	冤枉；太冤枉
吴刚砍桂树	没完没：了
蜈蚣吃蝎子	以毒攻毒
蜈蚣遇到眼镜蛇	一个此一个毒
蜈蚣遇公鸡	命难逃
五百罗汉斗观音	兴师动众
五百年前的老槐树	盘根错节
五百铜钱串一处	半吊子
五尺布做裤衩	宽打窄用
五尺檩条盖鸡窝	屈了材料
五尺深的浑水潭	看不透
五朵梅花开一朵	四肢（枝）无力
五个和尚化缘	三心二意
五个指头两边矮	三长两短
五更天唱曲子	高兴得太早了
五更天的梆子	处处挨打
五更天的星星	稀少
五更天起床	渐渐明白
五更天下大雪	天明地白
五花大肉	有肥有肉
五黄六月长疥疮	热闹（挠）
五黄六月穿棉袄	摆阔气
五句话分两次讲	三言两语
五十两元宝	一定（锭）
五台山上拜佛	烧高香
五台山上的莽和尚	横头横脑
五月的麦子	黄了；一天变个样
五月的石榴花	一片红火；红火一片
五月天喝凉茶	美透了
午后见阳光	每况愈下
伍子胥过昭关	一夜愁白了头
忤逆子戴孝	装模作样
忤逆子讲《孝经》	假仁假义
武大郎的扁担	长不了
武大郎的身子	不够尺寸
武大郎肚子痛	死到临头；死在眼前
武大郎放风筝	起手不高
武大郎服毒	吃也死，不吃也死
武大郎开店	不容大个儿
武大郎开豆腐店	人软货不硬
武大郎看飞机	眼界不高
武大郎卖刺猬	扎手
武大郎卖面包	人土货洋
武大郎卖盆	一套一套的
武大郎攀杠子	上不着天，下不着地；自不量力；上下够不着
武大郎骑骆驼	能上不能下
武大郎娶妻	凶多吉少
武大郎耍棍子	人熊家伙笨
武大郎跳舞	抱粗腿
武大郎捉奸	力不能及；反被害了性命
武大郎坐天下	无人敢保
武大郎做知县	出身不高
武科场上选将	有本事就上
武松打店	自家人不识自家人；一家人不认一家人
武松打虎	一举成名；艺高胆大；气概不凡
武松打兔子	英雄无用武之地
武松看鸭子	英雄无用武之地
武松卖刺猬	人强货扎手
武松绣花	胆大心细
武竺景阳岗上遇大虫（老虎）	不是虎死，就是人伤
捂着鼻子闭着嘴	憋气；憋得难受
捂着鼻子讲卫生	不闻不问
捂着耳朵放炮	怕听偏见
捂着耳朵偷铃铛	自己骗自己
捂着脑袋赶老鼠	抱头鼠窜
捂着屁股过河	小心过度（渡）
捂着钱包捉贼	过分小心；小心过余
捂着眼睛捉麻雀	瞎摸
舞台上拜天地	假的
舞台上的道具	任人摆布；由人摆布
舞台上的二人转	一唱一和
舞台上的鼓槌	一对儿
舞台上的皮影戏	幕后操纵
舞台上喝酒	不见得有
雾里看指纹	看不出道道
雾天看远山	朦艨胧胧
雾中照相	眉目不清
雾中追车	路线不明
西北风刮蒺藜（ji li一年生草本植物。果皮有尖刺）	连讽（风）带刺
西瓜长爪子	能滚能爬
西瓜地里放野猪	一塌糊涂
西瓜地里落冰雹	砸啦
西瓜地里散步	左右逢源（圆）
西瓜掉在油桶里	滑头；滑头滑脑
西瓜落地	滚瓜烂熟
西瓜抹油	圆滑；又圆又滑
西瓜碰上菜刀	四分五裂
西瓜皮擦屁股	没完
西瓜皮搓澡	没完没了
西瓜皮钉鞋掌	开溜（比喻偷偷溜走。）；溜啦；不是这块料
西瓜皮揩屁股	一塌糊涂；不干不净
西瓜皮做帽子	霉到顶了；滑头滑脑；滑头
西瓜瓤里生蛆	坏透了
西瓜甜不甜	看心
西瓜子拌豆腐	黑白分明
西湖边搭草棚	煞风景
西门庆请武大郎	没安好心
西面敲鼓东面响	声东击西
西山猛虎不咬人	有假无真
西施掉了门牙	美中不足
西施上庵堂	美妙（庙）
西施坐飞机	美上天了
西天取经	任重道远
西厢记做枕头	痴人说梦
西装配拖鞋	不伦不类
吸烟烧枕头	自找麻烦
惜钱不治病	自己跟自己过不去
稀饭倒进口袋里	装糊涂
稀饭锅里扔铁砣	混蛋到底
稀饭铺路	一塌糊涂
稀狗屎上叉	白搭
稀泥巴搀水	难收拾；不可收拾
稀泥巴糊墙	扶不上去
稀泥巴里打桩	深不得，浅不得
稀泥蛋子	软货
稀泥抹墙	敷衍了事
嘻嘻哈哈，年过十八	虚度年华
膝盖上打瞌睡	自己靠自己
膝盖上钉掌	离题（蹄）太远
膝盖上放鸡蛋	不牢靠
膝盖头套袜子	不对路数
蟋蟀打架	看谁嘴硬
蟋蟀斗公鸡	各有一长
席包泥巴做被盖	卷土重来
席辫子上走棋子儿	不对路数
媳妇向公公借钱	挪用公款
洗菜的洗莱，剥葱的剥葱	各管一工
洗脚盆里游泳	扑腾不开，水平太低
洗脚盆做染缸	看你怎么摆布
洗脚水倒在秧田里	物尽其用
洗脚水倒在阴沟里	臭到一块了
洗脸盆里洗澡	扑腾不开
洗脸盆里游泳	水平太低（比喻学习、工作或能力太差。）
洗脸水里对硫酸	越洗越难看
洗米箩里出烟	淘气
洗衣不用搓板	凭两只手
喜欢狗狗舔口，喜欢猫猫上灶	不识抬举
喜马拉雅山上摆手	高招
喜马拉雅山上鸡儿叫	名（鸣）声远扬；远近闻名（鸣）；高明（鸣）
喜马拉雅山上卖牛黄	又高又贵；高贵
喜鹊的尾巴	爱翘
喜鹊登枝喳喳叫	无喜乐三分
喜鹊回窝凤还巢	安居乐业
喜鹊老鸦同枝叫	又喜又悲；悲喜交加
喜鹊落满树，乌鸦漫天飞	吉凶未卜
喜鹊落头上	红运将至
喜鹊窝里掏凤凰	搞错地方了
喜事碰上丧事	有哭有笑；又哭又笑；哭的哭；笑的笑
戏场里头打瞌睡	图热闹
戏台后头的锣鼓	没见过大场面
戏台上拜天地	快活一时
戏台上扮夫妻	假装；有名无实；无情无义
戏台上打架	没事儿；无关痛痒；不痛不痒
戏台上的绸子舞	抖起来了
戏台上的刀枪	全是假的
戏台上的灯光	引人注目
戏台上的夫妻	有名无实
戏台上的服饰	好景不长
戏台上的父子	没大没小
戏台上的公子	离不开扇子
戏台上的鼓槌	成双成对
戏台上的官	难长久；长不子
戏台上的花旦	引人注目
戏台上的皇帝	假威风
戏台上的将军	神气一时
戏台上的�r头	叫干啥就干啥
戏台上的娄罗	轮不到你（我）唱
戏台上的娄罗兵	多一个少一个无所谓；只能靠边站
戏台上的媒婆	妖里妖气
戏台上的朋友	假仁假义；虚情假意
戏台上的韦生	一表斯文
戏台上的小生	能文能武
戏台上的小卒	走过场
戏台上的演员	装模作样；装样子
戏台上的钟旭	不怕鬼
戏台上堵枪眼	死不了
戏台上赌咒	口是心非
戏台上卖螃蟹	买卖不大，：架子不小
戏台上跑龙套	走过场；摇旗呐喊
戏台上起年号	称王称霸
戏台上娶亲	欢乐一时说一时
戏台上收锣鼓	没戏唱了
戏台上死人	不能当真
戏台上送诏书	假传圣旨
戏台上谈恋爱	假情假意
戏台上讨老婆	假的
戏台下掉泪	替古人担忧
戏台下面开店铺	光图热闹
戏台下面淌眼泪	替古人担忧
戏台子下读《四书》	闹中取静
戏娃子转圈圈	走过场
戏园里的枣木梆子	天生挨揍
戏园里挑媳妇	气厢情愿
戏园子里的挂钟	群众观点
戏园子里看《论语》	心不在焉
戏园子里拉大幕	个切完事
戏园子门前堆垃圾	煞风景
戏园子失火	彻底垮台
戏院里挂钟	群众观点（比喻大家的看法）
戏子（旧时称职业的戏曲演员）搽脸蛋	光图表面
戏子搽脸蛋	光图表面
戏子戴面具	面目全非
戏子的胡须	假的；挂上的
戏子的脸蛋	要哭就哭，要笑就笑
戏子没卸装	油头粉面
细高挑儿（身材细长的人）进矮门	不得不低头
细篾条穿冰粉	难题（提）
虾兵蟹将串门子	水里来，水里去
虾公掉进烫锅里	落个大红脸
虾公头上戴大枪	没人怕
虾子掉在大麦上	忙（芒）上加忙（芒）
虾子掉在盐堆里	忙（芒）中有闲（咸）
虾子过河	谦虚（牵须）
瞎狗逮兔子	碰到嘴上
瞎姑娘戴眼镜	多一层比少一层好
瞎了眼的癞皮狗	碰着啥咬啥
瞎驴推磨盘	团团转
瞎骡子打里（拉里套）	乱套了
瞎猫啃骨头	咬住不放
瞎猫碰着死耗子	难得；得之不易；赶得巧；正好
瞎猫抓鸡	死不丢
瞎猫抓住个死耗子	碰上了（比喻偶然遇上）
瞎猫抓住死老鼠	咬住不放
瞎妹子当媒人	自顾不暇
瞎娘抱着向娃娃	人家不夸自家夸
瞎牛撞草堆	碰着就吃
瞎婆娘彩西洋景	白花钱
瞎眼跛脚驴	顾（雇）不得
瞎眼吃杂碎	啥都有
瞎眼鸡叼虫子	碰运气
瞎子熬糖	恼（老）了火（比喻十分生气、恼怒。）
瞎子拜见岳父	有眼不识泰山
瞎子拜见丈人	有眼不识泰山
瞎子帮忙	越帮越忙
瞎子背拐子（腿脚瘸的人）	取长补短
瞎子背拐子过河	两全其美（比喻两方面都照顾得很圆满。）
瞎子背拐子走	由你指点；各尽其能
瞎子背瘸子	谁也离不开谁；各取所长
瞎子背瞎子	忙（盲）上加忙（盲）（比匕喻特别忙。）
瞎子背着拐子走	各尽其能
瞎子奔南墙	不碰不回头
瞎子踩高跷	盲目冒险
瞎子唱花脸	瞎喊
瞎子吃核桃	砸了手
瞎子吃黄瓜	不分老嫩
瞎子吃馄钝	肚里有数
瞎子吃芥末（调味品。味辣）	干瞪眼
瞎子吃螃蟹	只只好；个个好
瞎子吃汤圆	心中有数
瞎子吃羊肉	块块好
瞎子吃鱼	摸不着头尾
瞎子出门	盲目行动
瞎子吹蜡烛	胡吹一气
瞎子打靶	没准儿
瞎子打灯笼	看不到前程
瞎子打电筒	只照别人
瞎子打哈哈	盲目乐观
瞎子打架	揪住不放（比喻老抓住缺，点或错误，作为把柄。或指摘不完。）
瞎子打瞌睡	不显眼；不知不觉
瞎子打婆娘	抓住不放；揪住不放
瞎子打枪	漫无目标
瞎子打手电	只照人家，不照自己
瞎子打蚊子	白费力气
瞎子戴手表	摆设
瞎子戴眼镜	多余的框框；装模作样；多此一举；多一层不如少一层；多余
瞎子当向导	摸不清方向
瞎子的拐杖	离不得
瞎子点灯	白费蜡
瞎子掉下崖	凶多吉少
瞎子丢拐杖	无依无靠；没靠头
瞎子放驴	随它去
瞎子放牛	松不得手
瞎子放羊	由它去；随它去
瞎子付了灯油钱	明吃亏
瞎子盖被子	东拉西扯
瞎子干活	靠摸
瞎子跟绳走	摸索前进
瞎子跟着娶媳妇的笑	瞎凑热闹
瞎子跟着笑	随声附和；盲目乐观
瞎子钩鱼	只照人家，不照自己
瞎子逛大街	目中无人
瞎子逛商店	目空一切
瞎子过独木桥	盲目冒险；死路一条
瞎子过桥	提心吊胆
瞎子过索道	提心吊胆
瞎子过鱼鳞坑	栽不完的跟头
瞎子害眼病	根底坏；没法治；无关大局
瞎子哼曲子	盲目乐观
瞎子挤到三岔口	不知走哪条路
瞎子夹豆腐	不烂搞到烂（比喻把东西搞坏。含有责备的意思。或比喻捣乱。或比办事、说话，越办越糟，弄巧成拙。）
瞎子架电线	胡扯
瞎子嫁瘸子	两将就；两凑合
瞎子叫好	随声附和
瞎子接亲	难见人
瞎子进村	摸不着门
瞎子进花园	没什么好看的
瞎子进面馆	只认吃
瞎子进书房	不认输（书）
瞎子进学堂	不认输（书）
瞎子敬神	盲目崇拜
瞎子救人	胡扑打
瞎子开锁	碰对了
瞎子看书	观点不明
瞎子看天	不知早晚
瞎子看西洋景	枉费功；白费劲
瞎子看戏	视而不见；目中无人
瞎子看哑剧	一无所获
瞎子看钟	观点不明
瞎子拉二胡	练好的本领
瞎子拉胡琴	练好的本领
瞎子理乱麻	找不着头绪
瞎子捋（lv 用手指顺着抹过去，使物体顺溜或干净）胡子	莫（摸）须有
瞎子买电视机	给别人看的（比喻摆样子。）
瞎子买锅	摸底
瞎子买日历	胡扯
瞎子摸城墙	没头没尾；没尽头
瞎子摸窗户	找门道
瞎子摸到三岔口	不知所措
瞎子摸墙	找门道；无门儿
瞎子摸象	各说各有理：有偏见
瞎子摸鱼	瞎摸；碰运气；枉费心机
瞎子摸着蜜罐子	尝到甜头
瞎子磨刀	快了
瞎子拿报	你看
瞎子爬窗户	摸不着门道
瞎子爬树	不知高低
瞎子拍大腿	不高兴
瞎子跑夜路	难上加难
瞎子骑驴	一条道走到黑
瞎子骑瞎马	不对路数
瞎子敲城墙	找门路
瞎子娶老婆	不管美丑
瞎子染布	不知深浅
瞎子纫（ren 引线穿过针鼻儿）上了针	凑巧了；赶巧了；正好
瞎子纫针	对不上眼；自找苦吃；摸不着门道
瞎子三天不洗脸	眼不见为净
瞎子上坟	估堆
瞎子上工	摸索着干
瞎子上轿	摸不着门道
瞎子上街	摸出来的
瞎子上楼梯	不知道高低
瞎子上梯子	一步步来
瞎子射箭	无的放矢
瞎子伸手	没（摸）钱
瞎子说鬼	不可言状
瞎子死了儿	没指望
瞎子死了儿子	没指望了
瞎子讨饭	摸不着门道
瞎子跳高	凶多吉少
瞎子跳加官（旧时戏曲开场或演出中，遇显贵到场时，加演的舞蹈节目）	盲目乐观
瞎子跳舞	盲目乐观
瞎子贴布告	倒贴
瞎子望天窗	不明不白
瞎子相（xiang）婆娘	难见人
瞎子相亲	对不上眼；不对眼
瞎子栽树	死活不管
瞎子摘葫芦	顺藤摸瓜
瞎子找对象	不知丑俊
瞎子住山洞	暗无天日
瞎子抓琵琶	乱弹琴
瞎子抓婆娘	死不丢
瞎子捉鬼	没影的事
瞎子走路	不分日夜；难见天日
瞎子钻进小胡同	处处碰壁
瞎子作揖	盲目崇拜
瞎子坐飞机	不知高低
瞎子坐上席	目中无人
下巴底下支砖头	难开口；不好开口
下大雪找蹄印	罕见
下地不穿鞋	脚踏实地
下贱陀螺	不打不转
下轿打轿夫	不识抬举；恩将仇恨；以怨报德
下了地狱才后悔	来不及了
下了锅的面条	硬不起来；软下来了
下了山的老虎	不如狗（比喻失去了当年的威势。）
下棋走子儿	格格不入
下山担柴	心（薪）挂两头
下水船走不动	风水不顺
下水道安灯	照管
下水救落婴	舍己为人
下雪天穿裙子	美丽又动（冻）人
下雪天打兔子	白跑
下雪天走路	一步一个脚印
下雨不撑伞	淋（轮）着啦
下雨不戴帽子	轮（淋）到头上
下雨洒街，刮风扫地	多此一举
下雨天背棉絮	越背越重
下雨天出太阳	假情（晴）；阴不阴来阳不阳
下雨天打麦子	收不了场；难收场
下雨天浇地	多此一举
下雨天泼街	假积极
下雨天走路	拖泥带水
下雨往屋里跑	淋（轮）不到
夏天的烘笼	没用处；挂起来了
夏天的火炉	挨不得
夏天的扇子	人人欢喜；个个喜爱
夏天的袜子	可有可无
夏天的萤火虫	若明若暗
夏夜走棋	星罗棋布
夏至插秧	晚了；迟了
仙姑思凡	心野了
仙鹤打架	绕脖子
仙女的裙子	拖拖拉拉
仙女散花	天花乱坠
仙女下凡	腾云驾雾；飘飘然
先穿靴后穿裤	乱了套
掀翻了抱鸡窝	弄出许多谎（黄）来
掀菩萨烧庙宇	无恶不作
鲜花插在牛屎上	配不上；不配
鲜鱼烂虾一锅煮	不知好歹；好歹不分
闲人生闲气	无事生非
闲着没事摸锅底	给自己抹黑
咸菜拌豆腐	有言（盐）在先
咸菜缸里的秤砣	一言（盐）难尽（进）
咸菜缸里养白螺	难养活
咸菜缸里养田螺	难养活
咸菜煮豆腐	不必多言（盐）
咸鸡蛋	老腌（淹）哪
咸肉里加酱油	多此一举
咸鱼落塘	不知死活
咸鱼下水	假新鲜
显微镜下看细菌	一目了然；清清楚楚；一清二楚
显微镜下瞧东西	一孔之见
县长打老子	公事公办
县太爷出文告	官腔官调
县太爷盗金库	财迷心窍；财迷
县太爷告老	充权
县太爷门前打鼓	鸣冤叫屈
县太爷审他爹	公事公办
现代人穿古装	不是时候
线头穿进针孔里	对上眼了
线头落针眼	凑巧了；赶巧了；正好
线团打架	纠缠不清
线团子打滚	难缠
陷阱里的猎物	束手就擒
乡里婆婆拜干佛	磕头磕够了
乡下姑娘城里人打扮	半土半洋；不土不洋
乡下人不识走马灯	来的来，去的去；去了又来
乡下人穿大褂	必有正事
乡下人穿西装	土洋结合
相（xiang）媳妇的扭头	看不上眼
相逢不下鞍	各奔前程
相片扔到大海里	丢人不知深浅
相声表演	笑话连篇
香肠做链子	锁不住
香龛上挂粪桶	臭死祖先
香炉里长草	慌（荒）了神
香炉上打喷嚏	碰一鼻子灰
香签棍搭桥	难过
香山的卧佛	大手大脚
香水洗狐狸	臊气还在
湘绣被面包画册	话（画）里有话（画）
想吃鱼又避腥	难得两全
向棺材里的人讨帐	逼死人
向和尚借梳子	找错了门
向河里泼水	随大流
向傻子问路	一问三不知
巷道扛椽（chu6n）子	直来直去；直出直人
巷窄遇仇人	狭路相逢
项羽设宴请刘邦	不好心；居心不良
项羽砸锅	破釜沉舟
象棋斗胜	纸上谈兵
象棋盘里走跳棋	不对路数
象棋子走在线路上	格格不入
象牙筷子挑凉粉	滑头对滑头
橡皮擦子	有错就改
橡皮钉子	不软不硬
橡皮棍子打人	软收拾；无伤痕；外伤好治，内伤难医
橡皮棍子做旗杆	树（竖）不起来
橡皮脑袋	难开窍；不开窍
橡皮人救火	自身难保
橡皮人	能软能硬
橡皮糖	扯得长
消防队的汽车	通行无阻；畅通无阻
消防龙头打不开	干着急
萧何月下追韩信	为国操劳；连夜赶；爱才：谋士识良才
硝酸加盐酸	放到哪，烂到哪
小案板当锅盖	随方就圆；随得方就得圆
小车不抹油	干叫唤
小车掉进泥潭里	进退两难
小池塘撒网	一网打尽
小虫吃李子	心里肯（啃）
小虫子啃沙犁	暗里使坏
小丑化装	粉墨登场
小丑跳梁	自取灭亡
小瓷碗里数汤圆	明摆着
小葱拌豆腐	一清（青）二白
小鼎锅想炖大牛头	好大的胃口
小豆干饭	闷（焖）起来了
小二黑结婚	新事新办；情投意合
小二姐要饭	放不下脸；脸面上下不来
小二姐走钢丝	无依无靠
小擀杖掉油缸	又奸（尖）又猾（滑）
小擀杖放到醋缸里	又尖又酸；尖酸
小哥俩出师	各奔前程
小狗落屎坑	不愁吃
小狗娃跌屎坑	饱餐一顿
小姑打碗怨媳妇	错怪
小姑娘的辫子	两边摆
小姑娘的脸蛋	讨人爱；爱煞人
小姑娘逗娃娃	嘻嘻哈哈
小寡妇梦见丈夫	心里想
小寡妇上坟	越哭越伤心；哭得好伤心
小寡妇上轿	喜事来了；破涕为笑
小闺女的脾气	羞羞答答
小鬼拜见张天师	自投罗网
小鬼吹火	扇阴风
小鬼打城隍	死都不怕
小鬼见佛陀（释迦牟尼）	矮了半截子；矮了一大截
小鬼看见钟馗Ikuf）像	望而生畏
小鬼门前告阎王	找错了衙门
小鬼梦里做皇上	痴心妄想
小鬼敲门	要人命
小鬼升城隍	小人得志
小锅里煮猪头	盛不下
小孩掰竹笋	拔尖
小孩抽陀螺	团团转；不打不转
小孩穿大鞋	没法提；提不起来；提不得
小孩吹喇叭	口气不大
小孩的屁股，醉汉的嘴巴	难控制
小孩放爆竹	又爱又怕
小孩放烟火	天花乱坠
小孩爬到井台上	太悬乎
小孩爬墙	高攀不上
小孩抬大轿	担当不起
小孩剃头	快了
小孩玩喇叭	吹了
小孩子摆神位	你哄我，我哄你
小孩子过家家	一会儿好，一会儿坏
小耗子骂大街	贼喊捉贼
小耗子欺大象	全凭会钻
小和尚念经	有口无心
小河沟里撑船	一竿子插到底
小河里捞石头	摸底
小胡同赶骆驼	直来直去
小胡同扛毛竹	难转弯；转不过弯来
小胡同里赶猪	直进直出；直出直人
小胡同里遇仇人	冤家路窄
小花猫捋（lv 用手指顺着抹过去，使物体顺溜或干净）胡子	未老先衰
小鸡不撒尿	自有便道
小鸡踩键盘	乱弹琴
小鸡吃胡豆（蚕豆）	难吞难咽
小鸡吃食	点头哈腰
小鸡的爪子	闲不住
小鸡配凤凰	想高攀；甭（beng不用）想
小鸡碰上鹰	一个喜来一个忧；喜的喜，忧的忧
小鸡入笼	身不由己；不由自主
小脚穿大鞋	不对号；对不上号
小脚老太太缠脚	裹足不前
小脚女人爬大坡	寸步难行
小脚女人上楼梯	步步难
小脚女人走路	东倒西歪；慢腾腾
小脚婆娘过独木桥	摇摇摆摆
小姐使丫鬟	百依百顺
小老鼠拉线团	大头在后面；大的在后头
小老鼠上秤盘	自称自
小鲤鱼戏水	吞吞吐吐
小两口斗口角	不劝自了
小两口观灯	喜气盈盈
小炉匠补锅	穷凑合；穷凑
小炉匠打铁	修修补补
小炉匠戴眼镜	专找碴子
小炉匠的家什	破铜烂铁
小马驹备鞍鞯（an jian鞍鞫。马鞍和垫在马鞍下的东西）	挨鞭子的日子到了
小马驹跟车	跑跑颠颠
小猫长胡子	摆设
小猫吃小鱼	有头有尾
小猫的脸	一日三变
小猫喝烧酒	够戗（够受的）
小猫娃拉屎	遮遮盖盖
小猫洗脸	马马虎虎
小毛驴戴耳环	累赘
小毛驴套大车	力不能及；力不从心；心有余而力不足
小毛驴驮碾盘	吃不住劲；浑身哆嗦；加重负担
小米点灯	犯（饭）不着
小米煮红薯	糊糊涂涂；糊里糊涂
小蜜蜂说话	甜言蜜语
小庙里的和尚	没见过大香火；默默无闻
小磨香油拌凉菜	个个喜爱
小拇指比大腿	差一大截；差一截子
小木匠干活	东一句（锯），西一句（锯）
小囡（nan 小孩儿）拔萝卜	拉倒
小尼姑看嫁妆	今世无缘
小朋友唱歌	同（童）声同（童）调
小婆㈠、妾）当家	做不了主；缺乏主见
小婆子上吊	吓唬大的
小铺子的抽屉	装蒜
小铺子的蒜	零揪
小树掐尖	光出岔子；净岔子
小水沟里撑大船	异想天开
小偷报警	贼喊捉贼
小偷被抓	六神无主；处处挨打
小偷不经吓	做贼心虚
小偷不用化装	贼头贼脑
小偷打官司	输定了
小偷打警察	岂有此理
小偷的钱包	不义之财
小偷盯耗子	贼眉鼠眼
小偷击鼓进大堂	恶人先告状
小偷进牧场	顺手牵羊
小偷碰见盗贼	恶人遇恶人
小偷遇警察	心神不安
小偷照镜子	贼头贼脑
小偷做梦	想偷
小秃的脑袋	一毛不拔
小秃跟着月亮走	谁也不沾谁的光
小秃头上插辣椒	红人
小秃头上打蜡	又光又滑
小娃娃吃甘蔗	一节节来
小娃娃的话	句句真言；句句实话
小娃娃的脸	要哭就哭，要笑就笑
小娃娃扛大梁	自不量力；不自量
小娃娃骑木马	愿上不愿下
小娃娃拾炮仗（爆竹）	慌了手脚
小娃娃耍单杠	高攀不上
小娃娃做游戏	不成重来
小碗吃饭	靠天（添）
小碗盖大碗	管不着
小王卖画	自卖自夸
小巫见大巫	矮了半截子；矮了一大截
小屋里耍扁担	处处碰壁
小媳妇回娘家	背包袱
小媳妇进婆家	忍气吞声
小媳妇哭爹妈	没完没了
小媳妇拿钥匙	有职无权；当家不做主
小媳妇	难当
小媳妇讨饭	死心眼
小媳妇坐轿	靠众人抬举
小巷子赶马车	难转弯；转不过弯来
小巷子抬大梁	直来直去
小小秧鸡下鹅蛋	自不量力
小学生看书	念念不忘
小押儿店（旧时靠收少量抵押品剥削穷人的小店铺）的掌柜	损透了
小鸭蛋冒充大鸡蛋	蒙混过关
小羊羔拉屎	稀稀拉拉
小鱼篓盛刺猬	难装；不好装
小轴承安大滚珠	对不上跟
小猪拱粮囤	记吃不记打
小猪抢食	吃里爬（扒）外
小猪钻灶	碰一鼻子灰
小竹棍敲鼓	有节奏
小卒拱老师	将了军；将军
小卒子过河	有去无回
校长看教师	一视同仁
校场坝的旗杆	光棍；光棍一条
校场里的土地	管得宽
蝎虎子（壁虎）打喷嚏	满嘴臊
蝎虎子断尾巴	脱身之计
蝎虎子上墙	无孔不入
蝎虎子掀门帘	露一小手
蝎虎子作揖	露两手
蝎子背蜈蚣	毒上加毒
蝎子炒辣椒	又毒又辣
蝎子戴礼帽	小毒人
蝎子当琵琶	谈（弹）不得；无法谈（弹）
蝎子的屁股	拍不得
蝎子的尾巴后娘的心	毒极了；最毒
蝎子放屁	毒气冲天
蝎子翘尾巴	好毒的一招
蝎子甩尾巴	毒汁四溅
蝎子蜈蚣拜把子（朋友结为异姓兄弟）	毒亡加毒
蝎子战蜈蚣	以毒攻毒
蝎子蜇（zhe蜂、蝎子等用毒刺刺人或动物）屁股	说不得
蝎子蜇蝎子	自家人不识自家人
蝎子钻进墙缝里	暗伤人；暗中伤人
斜楞眼掷色子	观点不正
斜阳照身影	自看自高
斜嘴开口	尽说歪话
鞋帮店里失火	丢面子；失面子
鞋帮做帽沿	高升了；能到顶了
鞋底打掌	硬往上贴
鞋底儿抹油	溜啦
鞋底抹油	溜了
鞋底上绣牡丹	中看不中用
鞋店里试脚	说长道短
鞋匠铺里丢楦头（xuan tou楦子）	自丢自丑
鞋壳篓里跑马	没几步跑头
鞋里安电灯	名角（明脚）
鞋里头跑马	没多大奔头
鞋面布做帽子	高升到顶了；高升
鞋上绣凤凰	能走不能飞
鞋上绣金凤	会走不会飞
鞋刷子脱毛	有板有眼
鞋头上刺花	前程似锦
鞋子里洒香水	过分讲究
写字不在行	出格
写字出了格	不在行
泄了气的轮胎	瘪了
泄了气的皮球	一下子就瘪了
泄了气的猪尿脬（sui pao膀胱）	瘪了
泻肚吃人参	无补
卸架的黄烟叶	蔫（nian花木、水果等因失去所含水分而萎缩）了
卸磨杀驴	忘恩负义
屑窗户纸的	一捅就破；不透风
屑电棒（手电筒）的光	照见别人，照不见自己；照人不照己
屑疯狗的	见人就咬；乱咬人
屑喜鹊的	好登高枝
谢了花的南瓜	一天比一天有长进；一天比一天大
心坎上挂笊篱（zhaoli 捞取东西的用具。用金属丝、竹篾或柳条等制成。有长柄）	劳（捞）心了
心口挂灯笼	心照不宣
心口上挂秤蛇	称（chen）（称）心
心里塞团麻	乱糟糟；千头万绪
心里头长草	慌（荒）了
心眼里灌铅	不开窍；难开窍
心有灵犀	一点通
心字头上一把刀	忍了
新袄打补丁	多此一举
新辟的航道	畅通无阻；通行无阻
新春的横批	万事如意
新搭的台子	有戏唱啦
新褡裢（da lian中间开口的长方形口袋）换个破口袋	一代（袋）不如一代（袋）
新打的剪刀	难开口
新箍的马桶	三日香
新疆的哈密瓜	甜甜蜜蜜
新开的染房	不给点颜色看还行
新开张的杂货店	要啥有啥
新科状元招附马	喜上加喜
新郎官戴孝	悲喜交加；又喜又悲
新郎官揭盖头	真相大白
新郎新娘喝喜酒	正在热乎劲上
新棉袄打补丁	装穷
新棉花网被絮	软胎子
新娘子的头发	输（梳）得光
新娘子咬生馒头	人生面不熟
新女婿请接生婆	双喜临门
新娶的媳妇	春风满面
新上门的姑爷	不敢坐上席
新上市的黄瓜	带刺
新上套的驴驹子	不老实
新生的婴儿	一无所知
新媳妇拜年	彬彬有礼
新媳妇不上轿	不识抬举
新媳妇吃饭	细嚼慢咽
新媳妇过门	人生地不熟；人地两生
新媳妇哭公公	说不出个好来
新媳妇上花轿	心里美；忸忸怩怩；羞羞答答
新媳妇推车子	好的在后头
新媳妇推磨子	头一遭；头一回
新媳妇下轿	由人摆布；任人摆布
新媳妇照镜子	自我欣赏
新媳妇坐轿	头一回
新鞋打掌子	多余
新鞋落地	头一回；头一遭
新鞋踏臭屎	白糟踏
新修的马路	没辙
新衣服打补丁	不象样
新栽的杨柳	光棍一条
新战士打靶	头一回；头一遭
星球大战	惊天动地
猩猩戴礼帽	装文明人
刑部的后身	老（牢）眼
刑场上跳舞	死中作乐
刑法条文糊衣裳	满身是罪名
行车有车道，行船有航道	各不相干
行船不划桨	随大流
行船进了断头浜（bang 小河）	没有出路
行盗遇火灾	趁火打劫
行军遇伏兵	出师不利
行路人换草鞋	弃旧图新
行医的捎带卖棺材	死活都要钱
行云流水	难以捉摸；不好捉摸
杏花村的酒	有后劲；后劲大
凶神扮恶鬼	又凶又恶
兄弟二人猜拳	哥俩好
兄妹上大学	志同道合
胸脯长牙	心里狠
胸脯上挂茄子	多心
胸脯中了箭	伤心；伤透心
胸口安雷管	心胆俱裂
胸口摆天平	称（chen）（称）心
胸口长瘤子	有外心；生了外心
胸口长牙齿	怀恨在心
胸口放磨盘	推心置腹
胸口挂秤砣	心里沉重
胸口挂琵琶	谈（弹）心
胸口画娃娃	心上人
胸口拉弦子	乐开怀
胸口塞羊毛	乱糟糟
胸口上挂剪刀	别出心裁
胸口贴照片	心上人
胸口外面生杂草	心里慌（荒）
胸口掖扁担	横了心
胸前害疮，背后流脓	坏透了
胸窝里挂门板	好大的牌子
胸窝里栽牡丹	心花怒放
雄鹰的翅膀	练的
雄珠开花	没结果
熊瞎子拜年	不敢受这个礼
熊瞎子吃粽粑（zong ba粽子）	解不开
熊瞎子打立正	混充人样；装人样
熊瞎子上戏台	熊样
熊瞎子耍棒子	胡抡
熊瞎子耍马枪	露一手
熊瞎子舔马蜂窝	怕挨蜇别想吃甜头
熊瞎子学绣花	装模作样；装样子
修锅匠拉风箱	有去有来；有来有往
修脚带拔牙	上下兼顾
朽木搭桥	难过
朽木雕石猴	坏孩子
朽木棺材	坑死人
朽木桩子	一推便倒；一碰就倒
朽木做梁柱	无用之材
秀才背书	出口成章
秀才打架	讲礼
秀才当兵	能文能武；文武双全
秀才的手巾	包输（书）
秀才挥笔	大作文章
秀才看榜	又喜又惊
秀才落陷阱	埋没人才
秀才拿笤帚	斯文扫地
秀才念书	咬文嚼字
秀才跳井	明白人办糊涂事
秀才推磨	难为圣人
秀才行凶	一笔抹杀
秀才遇见兵	有理说不清
绣房里的花枕头	摆设
绣花被面补裤子	大材小用
绣花姑娘打架	针锋相对
绣花姑娘打老虎	胆大心细
绣花姑娘的家什	真（针）好
绣花姑娘的手艺	千真（针）万真（针）
绣花针沉海底	无影无踪
绣花针戳乌龟壳	穿不过去
绣花针当棒槌	小题大做
绣花针对铁梁	各有一技之长；大小各有用场
绣花针纳鞋底	难通过；通不过
绣花针碰上吸铁石	沾上了
绣花针挑土	难得；得之不易
绣花枕头稻草心	肚里没好货
绣花枕头塞糠壳	顾面不顾里
绣花枕头	一包草；华而不实
绣花枕头一包糠	外光里不光；表匾光
绣楼里的闺秀	上不了阵势
绣娘爱针线，牧人爱牛羊	干一行爱一行
绣娘缝嫁女	为别人操劳
绣在地上的花	任人践踏；由人踩
袖短怪罪胳膊长	错怪
袖简里捅宝剑	杀人不露锋
袖里来，袖里去	无根无据；何凭何据
袖筒里揣棒槌	直来直去；直出直入
袖筒里揣刀子	暗藏杀机
袖筒里打麻将	扒拉不开
袖筒里伸出一只脚	夸大手
袖筒里伸爪爪	露一小手
袖筒里掖（ye 塞进）旗杆	不知长短
袖子里的火	抖落不了
袖子里冒火	着手
锈坏的轱辘（gu lu车轮子）	玩不转
锈坏的铁钉	抠不出来
徐庶进曹营	一言不发
许不下羊羔许骆驼	巧言哄人
许了身子还挨嘴巴	太冤枉
许仙碰见娘子	天配良缘
许仙碰着白娘子	天降良缘
宣传车演节目	载歌载舞
宣统坐江山	只有三年
悬崖边上打太极拳	临危不乱
悬崖边止步	停滞（止）不前
悬崖上翻跟头	送死；自己找死；凶多吉少
悬崖上勒马	化险为夷
悬崖上扭秧歌	高兴到头了
旋风吹到嘴里	邪风人内
漩涡里洗澡	越陷越深
选帽子挑鞋子	评头论足
癣（xuan）疥之疾	无关紧要；无关大局
靴子里抹胶	沾上了
靴子梦见帽子	想高攀
薛仁贵的行头	白跑（白袍）
薛仁贵征东	劳而无功；有劳无功
学理发碰上大胡子	难题（剃）
丫鬟抱孩子	人家的
丫鬟带钥匙	有职无权；当家不做主
丫鬟戴凤冠	不配
丫鬟枕着元宝睡	守财奴
丫头当媒人	自身难保
鸭背上泼水	劳而无功；两不沾；不沾
鸭吃长虫	缠往了
鸭吃大椒	直摇头
鸭脚上挂铜铃	响当当；当当响
鸭棚的老汉睡懒觉	不简（拣）单（蛋）
鸭棚老汉睡懒觉	不简单（捡蛋）
鸭绒被裹尸体	舒服死啦
鸭绒裹尸体	舒服死啦
鸭头安在鹅颈上	不像样
鸭吞筷子	脖硬
鸭子背上泼水	光啦
鸭子不吃瘪谷	肚里有货
鸭子不吃小鱼	眼朝天
鸭子不尿尿	自有便道
鸭子踩水	暗使劲
鸭子吃菠菜	连根儿铲
鸭子吃糠壳	白欢喜；空喜一场
鸭子吃青草	充大牲口
鸭子吃蛐蟮	生吞活剥
鸭子吃鳝鱼	吞吞吐吐
鸭子吃蜗牛	食而不知其味；全不知味
鸭子出世	没了娘
鸭子的脚板	连成一片
鸭子的屁股	爱翘；又圆又滑
鸭子的嘴	煮不烂
鸭子孵小鸡	白忙活
鸭子凫水	暗中使劲
鸭子浮水	飘飘然；暗中使劲；上松下紧
鸭子改鸡	磨嘴皮
鸭子呱呱狗吃屎	本性难移
鸭子过河	随大流
鸭子喊伴	呱呱叫
鸭子回娘家	大摇大摆
鸭子爬树	为难
鸭子上房展翅	算个什么鸟
鸭子上架	靠猛劲；逼的
鸭子上门槛	里外乱咄
鸭子死了	嘴还硬
鸭子头上插鸡毛	一语（羽）双关（冠）
鸭子头上长疮	一副恶（鹅）势
鸭子吞田螺	全不知味
鸭子下冻田	插不上嘴
鸭子下河滩	呱呱叫
鸭子下水	呱呱叫；嘴上前；各奔前程
鸭子扎猛子（游泳时头朝下钻到水里）	深入下层
鸭子走路	左右摇摆
鸭走娘家	大摇大摆
牙齿和舌头打架	伤不了和气
牙缝里插花	嘴里漂亮，
牙缝里剔肉吃	解不了馋；不过瘾
牙膏的脾气	不挤不出
牙签子搭桥	难过
牙痛贴膏药	胡摆治
崖缝里的马蜂	没人敢惹
崖头缝里逮螃蟹	十拿九稳
崖头上睡觉	不怕死
衙门的灯笼	正大光明
衙门的钱，下水的船	来得易，去得快
衙门口打警察	没事找事
衙门口的狮子	一对儿；张牙舞爪；假威风
衙门里打电话	官腔官调
衙门里打官司	认钱不认人
衙门里的酷吏，宅门里的狗	仗势欺人
衙门前贴告示	官样文章
衙门皂隶进宅	无事不来
衙门皂隶	仗势欺人
衙门皂子打老爹	公事公办
衙役的脸	说变就变；转眼就变；变化无常
哑巴挨打	有苦难诉；有苦说不出
哑巴挨夹杠（夹棍。刑具）	痛死不开腔
哑巴挨骂	气不可言
哑巴挨冤枉	有口难辩；至死不开腔
哑巴被驴踢	有苦说不出
哑巴被蜈蚣咬	痛不可言
哑巴长工（旧社会长年出卖劳力，受地主、富家剥削的贫苦农民）碰上娘	有苦难诉；有苦说不出
哑巴唱戏	没腔
哑巴吃黄连	有苦说不出
哑巴吃馄饨	心中有数
哑巴吃仙桃	妙不可言
哑巴传话，呆子打岔	说不清，道不明
哑巴打电话	语言不通
哑巴打官司	有理说不清
哑巴打手势	不言而喻；难理会
哑巴瞪眼睛	心里恨
哑巴肚里挂算盘	心中自有巧打算
哑巴喊救火	干急说不出
哑巴祭祖先	多磕头，少说话
哑巴见了妈	没说的
哑巴见了面	没话可说；无话可说
哑巴讲演	指手画脚
哑巴叫冤	有口难言
哑巴进庙	多磕头，少说话
哑巴看到失火	不好声张
哑巴梦见妈	有苦难诉；有苦说不出
哑巴亲嘴	各人心里爱
哑巴求医	说不出的毛病
哑巴娶老婆	喜不可言；喜在心里
哑巴伸冤	有口难辩
哑巴说大象	不可言状
哑巴说话聋子听	两不懂
哑巴说话	只可会意，不可言传
哑巴谈恋爱	好得没法说
哑巴蚊子咬人	不出声
哑巴蚊子	咬死人
哑巴咬牙	心里恨
哑巴有理说不清	干着急
哑巴做报告	张口结舌
哑巴做梦	说不得
哑子教书	难讲
哑子进公堂	有口难讲
哑子拿了一支筷	心想成双说不出
垭口上的新闻	道听途说
烟囱顶上长棵树	高不可攀
烟囱顶上走路	寸步难行
烟囱里的麻雀	黑道上来的
烟囱里的烟	直来直去
烟囱里屙屎	臭气熏天；出臭风头
烟囱里放醋坛	酸气冲天
烟囱里拘雀麻	没在那里面
烟囱里爬老鼠	直来直去；直进直出；直出直人
烟囱里招手	往黑处引
烟囱上面放棺材	熏死人
烟囱站岗，铁将军把门	全家都上
烟袋杆搭桥	难过
烟袋杆里插席篾儿	气不顺
烟袋锅烤手	没有热乎劲
烟袋锅里炒鸡蛋	请的哪门子客
烟袋锅里炒芝麻	小捣鼓
烟袋锅里蒸包子	有气也不大
烟袋锅里煮饭	捣鼓不开
烟锅里炒芝麻	小气（器）
烟灰抹面皮	黑下脏来
烟里的放醋坛	酸气冲天
烟筒里安家	没门
烟雾里赏花	模糊不清；看不清
胭脂当粉搽	闹了个大红脸
淹死鬼使计谋	勾别人下水
淹死鬼找替身	借尸还魂
淹死鬼拽（zhuai 拉）住岸边草	抓住不放；揪住不放
阉猪的割耳朵	外行
阉猪割耳朵	两头受罪
腌萝卜拌黄瓜	都闲（咸）着
严嵩挨打	自作自受
严嵩收礼	来者不拒
岩壁上打洞	旁敲侧击
岩缝里长蘑菇	憋出来的
岩石下画的竹笋	难出头
沿江道上开车	走弯路
沿着磨盘走路	没头没尾；没尽头；团团转
炎夏天打冷战	不寒而栗
炎夏天的火炉子	讨人嫌
盐场罢工	闲（咸）得发慌
盐场的伙计	爱管闲（咸）事
盐店的老板转行	不管闲（咸）事
盐店里卖气球	闲（咸）极生非（飞）
盐店里谈天	闲（咸）话多
盐堆里的花生	闲人（咸仁）
盐堆里爬出来的人	闲（咸）话不少
盐堆上安喇叭	闲（咸）话不少
盐缸里出蛆	稀奇
盐罐露头	闲（咸）人
盐碱地的身苗	稀稀拉拉
盐老板抱琵琶	闲谈（咸弹）
盐里生蛆虫	不可能的事；怪事一桩
盐咸地的庄稼	死不死，活不活；要死不活；奄奄一息；稀稀拉拉
阎罗王做生意	鬼都不上门
阎王摆手	没救；无法
阎王办事	鬼差
阎王扮观音	神不神，鬼不鬼；非神即鬼
阎王不戴帽	鬼头鬼脑
阎王出丧	鬼哭神嚎
阎王打瞌睡	点错了名
阎王的参谋	鬼点子多；诡（鬼）计多端
阎王的蒲扇	扇阴风
阎王殿里开染房	色鬼
阎王殿里卖狗皮膏药	骗鬼；哄死人
阎王殿里玩戏法	鬼花招
阎王给小鬼拜年	颠倒着做
阎王嫁女	抬轿的是鬼，坐轿的也是鬼
阎王开店	无人买
阎王开会	都不是人
阎王老爷嫁女儿	拾轿的是鬼，坐轿的也是鬼
阎王老子谈家常	尽讲鬼话
阎王老子做木匠	鬼斧神工
阎王奶奶害喜病	怀鬼胎
阎王奶奶绣荷包	鬼花招
阎王讨债	催命鬼
阎王吸鸦片	大烟鬼
阎王下请贴	离死不远；末日来临
阎王写文章	鬼话连篇
阎王爷变戏法	鬼把戏
阎王爷不戴帽子	鬼头鬼脑
阎王爷吃黄豆	鬼吵（炒）
阎王爷抽烟	鬼火直冒
阎王爷出天花	净是鬼点子
阎王爷的爸爸	老不死的鬼
阎王爷的扇子	两面阴
阎王爷的奏折	鬼话连篇
阎王爷点生死簿	一笔勾销
阎王爷好见	小鬼难缠
阎王爷开布店	鬼扯
阎王爷拉家常	讲鬼话
阎王爷敲门	内中有鬼
阎王爷请客	净是鬼
阎王爷上吊	短命鬼
阎王爷烧炕	点鬼火
阎王爷审案子	尽是鬼事
阎王爷使计谋	诡（鬼）计多端
阎王爷说谎	骗鬼
阎王爷死了	鬼哭神嚎
阎王爷讨口（讨饭）	穷鬼
阎王爷吸鸦片	大烟鬼
阎王爷下请贴	不去不行
阎王爷招手	没得救
阎王爷照镜子	鬼样子
阎王爷照相	鬼头鬼脑
阎王爷做的芝麻饼	鬼点子多
阎王桌上抓供果	送死
阎王嘴上拔胡子	寻死；自己找死．
颜料店的抹布	不分青红皂白；分不清青红皂白
掩耳盗铃	自欺欺人；自己哄自己
眼过千遍不如手过一遍	贵在实践
眼睛长在鼻尖下	悲观失望
眼睛长在耳朵边上	有偏见
眼睛长在后脑勺	朝后看
眼睛长锥子	真尖
眼睛瞪着孔方兄（钱。旧时的铜钱有方形的孔）	见钱眼开
眼睛看透三层壁	眼力好；好眼力
眼睛里插棒槌	受不了
眼睛里的沙子	容不得
眼睛上出芽了	不是好苗头
眼睛上套棉花	看不透
眼睛上贴钞票	认钱不认人
眼睛上贴膏药	遮人眼目
眼睛只瞅见鼻梁下两片肉	目光短浅
眼镜店里的交易	各对各眼
眼镜上贴膏药	遮人眼目；视而不见
眼镜蛇摆手	好毒的一招
眼镜蛇打喷嚏（pen ti ）	满嘴放毒
眼里的灰尘	不能容忍
眼里挑刺	细致活儿
眼皮上吊炊帚	耍（刷）嘴
眼前埋地雷	一触即发
眼前无战火，身后无追兵	平安无事
眼瞎耳聋鼻塞嘴哑	一窍不通
演古戏打破锣	陈词滥调
演双簧的	一唱一和
演双簧戏的表演	装腔作势
演完越剧唱京戏	南腔北调
演戏扮皇帝	神气一时
演戏扮司令	假威风
演戏的中状元	高兴一时说一时
演戏瞪眼睛	吓不住人
演员化装	涂脂抹粉
演员卸装	真相大白
演员谢幕	该下台了
宴席上摆狗肉	少见；少有
宴席上吵架	不欢而散
验血的扎耳朵	一针见血
堰头上洗脑壳	首当其冲
燕口夺泥	细索求；无中生有
燕窝掉地	家破人亡
燕子搭窝	嘴上功夫；全凭嘴；安家落户
燕子的嘴巴	两岔
燕子下江南	不辞劳苦
秧鸡子下田	顾头不顾尾
羊肠小道	绕来绕去
羊闯虎口	自送一口肉；送来的口食；有进无出
羊闯狼窝	白送死
羊吃青草猫吃鼠	各人有各人的福
羊抵角	顶顶撞撞；又顶又撞
羊儿不长角	狗头狗脑
羊儿不吃草	壮不了
羊粪蛋下山	滚蛋
羊羔踩到稀泥凼（dang 水坑）	不能自拔
羊角插在篱笆里	伸头容易缩头难
羊看菜园	靠不住；不可靠
羊拉屎	零零散散
羊毛里找跳蚤	没着落
羊圈里的驴粪蛋	数你大
羊圈里的骆驼	数它大
羊圈里关狼	自招灾祸
羊圈里跳出个驴来	显大个儿
羊群里的大象	突出
羊群里的骆驼，鸡群里的仙鹤	与众不向
羊群里跑出个小兔子	野种
羊群里跑骆驼	高人一头；身高气傲；抖威风
羊群里钻进一只狼	一团混乱；遭殃
羊群遇恶狼	各散四方；四处逃散
羊身上取驼毛	梦想；办不到；天下奇闻；无奇不有；白日做梦；没法办
羊头安在猪身上	颠倒黑白
羊头插到篱笆内	伸手（首）容易缩手（首）难
阳春三月的桃花	一片红火；越来越红火
阳雀叫三年	一句现成话
阳山吃草，阴山拉屎	背地里坏
杨二郎的兵器	两面三刀
杨二郎说书	神聊
杨国忠作宰相	江山难靠
杨家将出征	全家都上；一齐出动；男女老少齐上阵
杨令公的儿子	一个赛一个
杨乃武（《杨乃武与小白菜》中人物）坐牢	屈打成招
杨树的叶子	两面光
杨五郎削发	半路出家
杨志卖刀	忍痛割爱
杨宗保和穆桂英姻缘	打出来的
洋鬼子进村	鸡犬不宁
洋鬼子看戏	傻了眼
洋鬼子耍西洋镜	名堂多
洋灰（冰泥）地上种花生	扎不下根；难生根
洋灰脑袋	难开窍；死不开窍
洋娃娃穿古装	不伦不类
仰脸婆娘低头汉	难斗难缠
仰面朝天	眼朝上；眼向上看
仰着脖子吹唢呐	起高调
养个孩子学响马（旧称劫路的强盗）	有失家教
养济院里的孩子	穷小子
养济院里请客	穷凑合
养蛇咬自己	自取其祸；惹祸上身
幺店子（山问路边的小店铺）的新闻	道听途说
幺儿子娶媳妇	大事完毕
妖怪揍和尚	精打光
妖魔遇鬼怪	一对坏
腰带拿来围脖子	记（系）错了
腰间别雷管	没人敢惹
腰里别钢筋	腰杆子硬
腰里别镰刀	走到哪，干到哪
腰里别算盘	时刻为个人打算
腰里别着个死耗子	冒充打猎人
腰里插笊篱（zhao li捞取东西的用具。用金属丝、竹篾或柳条制成。有长柄）	走到哪捞到哪腰
腰里长枝条	出了邪岔（斜权）
腰里挂算盘	光为自己打算
腰里拴扁担	横行一方
腰上长出条腿	节外生枝
腰子上长出条腿	横生肢节
窑上的瓦盆	一套一套的
摇篮里的婴儿	是人不知道人事
摇着脑袋吃梅子	瞧你那个酸相
摇着扇子聊天	谈笑风生
咬口生姜喝口醋	尝尽辛酸
咬群的鸭子	难合群
咬人的狗不露齿	暗中伤人
咬住苦瓜当芒果	上当一回
舀米汤洗澡	尽办糊涂事
药材店里的抹桌布	五味俱全
药店的抹布	苦透了
药店里的甘草	离不得；一抓就来；少不得
药罐子里的枣子	虚胖
药罐子里斗蛐蛐儿（蟋蟀）	苦中取乐
药铺里挂蛇皮	打着吓人的幌子
药铺里卖棺材	往最坏处想
药铺里卖花圈	死活都要钱
药铺里招手	把人往苦处引
药王爷摆手	没法治；没治了
药王爷的匾	手到病除；妙手回春
药王爷的肚子	苦水多
药王爷的嘴	吃尽了苦头
要饭的拜把子（朋友结为异姓兄弟）	患难之交
要饭的不见了讨口棍	受狗欺
要饭的打摆子（患疟疾）	穷哆嗦
要饭的打狗	穷横；穷凶极恶
要饭的打竹板	耍贫嘴
要饭的给龙王上供	穷人有个穷心
要饭的借算盘	穷有穷打算
要饭的看丈母娘	穷孝顺
要饭的流眼泪	穷伤心
要饭的拿饼子	没有一块好的
要饭的拿戳子	逞（称）什么
要饭的起五更	穷忙
要饭的走到崖边上	穷途末路
要饭花子（乞丐）放炮	穷咋呼
要你抓鸡，你偏捉鹅	故意捣乱
要甜的拿糖罐，要酸的拿醋坛	得心应手
爷见孙，猫见窝	亲
爷俩打架	大惊小怪
爷俩掉到河里	各扑腾各的
爷俩分家	另起炉灶
爷俩赶集	一大一小
爷俩看见马打架	大惊小怪
爷爷的长相	老样子
爷爷棉袄孙子穿	老一套
爷爷孙子拜年	一大一小
爷爷同孙子赛跑	不服老
爷爷住茅屋，爸爸盖瓦房	一代比一代强；一辈强似一辈
耶稣堂关门	不讲道理
野地里烤火	一面热
野地里撵兔子	谁逮住就属谁
野地里烧火	就地取材
野地里遇疯狗	难近身；近不得身
野蜂飞进鱼网里	光钻空子
野鸽子起飞	下落不明；不知下落
野狐狸撒尿	骚气大
野狐狸舔虎鼻梁	溜须不要命
野鸡戴皮帽	冒充鹰
野鸡窠（ke 鸟兽昆虫栖息的处所）里抱麻雀	一窝不如一窝
野鸡生蛋	藏头露尾
野狼扒门	没安好心；来者不善
野马进了套马杆	伸手（首）容易缩手（首）难
野马脱缰	横冲直撞
野猫给老虎舔下巴	溜须不要命
野猫进宅	鸡犬不宁
野猫撵走家猫	喧宾夺主
野猫钻到鸡笼里	凶多吉少
野牛闯进火海里	有命没毛
野兽当家	荒凉
野猪借公鸡	有借无还
野猪刨红薯	全凭一张嘴；好硬的嘴；嘴硬
野猪头做贡物	虚情假意
野猪钻篱笆	两受夹；两头受挤
叶公好龙	口是心非
夜不关门	穷壮胆
夜叉（佛教指恶鬼）怀胎	肚里有鬼
夜叉（相貌丑陋、凶恶的人）骂街	不堪入耳
夜耗子偷食	黑天干事
夜壶摆在床底下	见不得人
夜壶打了把	光剩嘴了
夜壶里拉屎	又臊又臭
夜里攀险峰	不顾生死
夜里行船	摸不到边
夜猫子（猫头鹰）报喜	没好事
夜猫子唱歌	难人耳
夜猫子进宅	无事不来；没安好心
夜猫子拉小鸡	有去无回
夜猫子睡觉	睁只眼，闭只眼
夜明珠喘气	活宝
夜明珠埋在粪堆里	屈才（财）
夜晚打雷心不跳	问心无愧
夜行人吹哨子	给自己壮胆
夜行人迷了路	方向不明
夜莺配鹦鹉	正合适
夜莺学乌鸦叫	变坏了
掖着个孙悟空	憋出个猴来
一把黄豆数着卖	发不了大财
一把钥匙开一把锁	配就的
一把芝麻撒上天	星星点点
一百个和尚念经	异口同声
一百个人当家	不知听谁的
一百个人骂仗	多嘴多舌
一百个傻瓜给你磕头	大傻瓜
一百斤米做稀饭	难熬
一辈子当会计	长期打算
一辈子卖蒸馍	受不完的气
一辈子做寡妇	老手（守）
一锛两斧头	没有分寸
一本经书看到老	墨守成规；食古不化
一边弦子一边大鼓	你说你的，我干我的
一步跨进姨姐房	进退两难
一步一个脚印	脚踏实地
一层布做的夹袄	反正都是理（里）
一车破棉胎	不值钱的货
一尺厚的烧饼	吃不透
一打醋，二买盐	两不耽误；两得其便
一刀纸糊在鼻子上	好厚的脸皮；厚脸皮
一吊钱放在门槛上	里外半吊子
一斗芝麻拈一颗	有你不多，无你不少
一肚子加减乘除	心中有数
一堆乱树枝	七枝八杈
一堆脑瓜骨	没脸没皮
一对铃铛	不见空得慌，见面就叮哨
一顿能吃三升米	度（肚）量大
一分钱掰（bai用手把东西分开或折断）两瓣花	会过日子
一分钱开当铺	周转不开
一分钱买仨	分文不值
一分钱攥（zuan）出汗来	过日子的好手
一副碗筷两人用	不分彼此
一杆没星的秤	不知轻重
一个巴掌	拍不响
一个半斤，一个八两	没什么两样
一个病房的病友	同病相怜
一个吹笛，一个按眼	两不顶一
一个碟子摔九块	四分五裂
一个洞里的蛇	早有勾结
一个方凳坐两人	亲密无间
一个锅里吃饭	彼此彼此
一个葫芦锯两个瓢	一对儿
一个将军一个令	不知听谁的
一个萝卜一个坑	一个顶一个
一个马鞍上的人	同奔前程
一个模子出来的	一模一样；没什么两样；一个样
一个染缸里的布	一色货
一个人拜把子（朋友结为异姓兄弟）	你算老几
一个人唱台戏	独角
一个世纪才盘点	百年大计
一个骰子（tou zi色子。游戏用具或赌具）掷七点	出人意料
一个窝里的王八	龟子龟孙
一个窝里的蝎子	早有勾结
一个媳妇几个婆	不知听谁的
一个院里住两家	谁也知道谁
一个桩上拴两头牛	迟早要闯祸
一根肠子通到底	直性子
一根灯草点火	一条心
一根杠棒前后肩	谁也离不开谁
一根筷子吃莲菜（用作蔬莱的藕）	专挑眼；尽挑眼
一根筷子捡花生米	挑拨
一根木头劈八开	不大方
一根绳拴俩蚂蚱	谁也跑不了
一根藤上结的苦瓜	苦相连
一根桩上拴俩驴	谁也跑不了
一根桩上拴两头牛	互不相让
一跟头栽到屋外边	门里出身
一锅骨头汤	全是光棍
一锅米饭煮三年	难熬
一锅子混汤面	糊涂到一块
一会念叨娃，一会想起妈	心挂两头
一镬头（jue tou 刨土用的农具）挖到金条	运气好
一加一等于二	没错；错不了
一家人五更打牙祭（吃肉）	没外人
一家十五口	七嘴八舌
一江春水向东流	滚滚向前；无穷无尽
一脚踏进刺笆林	难脱身；脱不了身
一脚踏进稀泥凼（dang水坑）	不能自拔
一脚踏进云端里	一步登天；一跃而上
一脚踏两只船	左右为难
一脚踏上磅秤台	举足轻重
一脚踢不出个屁来	窝囊废
一脚踢死个麒麟	不知贵贱
一斤的酒瓶装十两	不多不少
一斤霉面做个馍	废物点心
一斤肉放进四两盐	闲（咸）人
一棵树上的核桃	有大有小
一棵树上的叶子	一模一样；一个样；没什么两样
一颗心悬在半天云里	上不着天，下不着地
一口吃个牛排	贪多嚼不烂
一口吃个旋风	好大的口气
一口吃了九个馒头	贪欲太大
一口吃条绳子	有内线
一口吃下扁担	横了心
一口吃下热红薯	难吞难咽
一口棺材睡两人	死对头
一口锅里舀饭吃	没外人
一口吞根擀面杖	直性人；直性子
一口咬断铁钉子	嘴上功夫；全凭嘴劲；好硬的嘴；嘴硬
一口咬了黄瓜蒂	苦
一筐子鳖倒在沙滩上	滚的滚，爬的爬；连滚带爬
一雷天下响	处处皆知
一粒米熬三碗汤	淡而无味
一粒子弹打两只鸟	一举两得
一轮红日出东方	光明芷大
一毛钱买了一筐蒜壳	贱皮子
一盘棋下了三天	棋逢对手
一屁股�荩�dun 重重往下放）在锣鼓上	音不正；没正音
一屁股坐在铡刀上	切肤之痛
一千文钱分四处	二百五
一千只麻雀炒一锅	多嘴多舌
一枪打两只黄羊	一举两得
一枪打死个苍蝇	得不偿失
一枪扎死杨六郎	没戏唱了
一锹挖出个金娃娃	异想天开
一群惊窝的耗子	灰溜溜的；灰不溜溜
一群老鸦朝南飞	一模一样；一个样
一群哑巴在一起	指手画脚
一人一把号	各畋各的调
一失足成千古恨	悔之莫及；后悔已晚
一时猫脸，一时豹脸	说变就变；变化无常；转眼就变
一手拿刺叭，一手托皮球	又吹又拍；吹吹拍拍
一手拿针，一手拿线	望眼欲穿
一手遮天，一手捂地	瞒上瞒下
一手抓泥鳅，一手逗黄鳝	两头耍滑
一塘的鸭子	呱呱叫
一天到晚淡茶饭	不吃香
一天卖三根黄瓜	发不了大财
一天三刮络腮胡	你不叫我露面，我不叫你露头
一天下了三场雨	缺少情（晴）意
一条船上的难友	风雨同舟；同舟共济
一条道走到黑	死心眼
一条犁沟走到底	死不回头
一条腿的板凳	站不住脚
一桶开水烫在狗身上	遍体鳞（淋）伤
一头栽到煤堆里	霉（煤）到顶了
一头撞倒阎王爷	冒失鬼
一头钻进风箱里	两头受气
一团乱麻	千头万绪；找不到头
一碗白开水	淡而无味
一网打尽天下鱼	想到办不到
一窝老鼠不嫌臊	气味相投
一窑烧的缸钵	一色货；一样的货色
一月穿三十双鞋	日日新
一张麦筛子	缺点多；尽缺点
一张鱼网千只眼	一环扣一环
一张纸画了三个鼻子	不要脸
一张嘴巴两张皮	横说竖说都有理
一丈高的房子，丈八长的菩萨	盛不下
一丈厚的烧饼	吃不透
一只脚踩在门槛上	不知进退
一只筷子吃面	独挑
一只筷子吃藕	专挑眼；尽挑眼
一只喇叭一把号	各吹各的调
一只螃蟹八只脚	没错；错不了
一只手吹笛	顾此失彼
一只手遮脸	独当一面
一嘴吞了个鞋帮子	心里有底
一嘴吞下仨馒头	吃不消；贪多嚼不烂
衣角扫死人	好威风
衣食不愁想当官，做了大官想成仙	贪得无厌；贪心不足
衣袖揩（kai 擦）屁股	自己搞臭自己
医生摆手	没法治；没治了
医院办火葬场	死活都要钱
医院里的死人	走后门
依了媳妇得罪娘	难得两全；两头难
依着葫芦画瓢	全盘照搬；照样
依着石碑烤火	一面热
宜兴的壶	好嘴
姨奶奶的枕头风	软中有硬
姨太太当家	小人得志
椅子底下着火	烧着屁股燎着心
椅子折了背	没靠头
阴曹地府开饭店	鬼上门
阴沟里荡舟船	寸步难行
阴沟里的狗尿苔（鬼笔。一种有毒的真菌）	见不得阳光
阴沟里的泥巴	扶不上墙
阴沟里的蚯蚓	成不了龙
阴沟里的旋风	刮不起来
阴沟里的鸭子	顾嘴不顾身
阴沟里翻船	没想到的事
阴沟里栽藕	底子臭；根子不正
阴沟石缝里的蛇蝎	暗伤人；暗里伤人
阴间秀才	阴阳怪气
阴天打阳伞	多此一举
阴天戴草帽	多此一举
阴天露日头	假情（晴）
阴天卖泥人	趁早收场
阴天晒褥子	不是时候
阴天树旗杆	四下不见影
阴雨天的霹雳	大发雷火
阴雨天的芝麻	难开口
阴雨天观景致	模糊不清；看不清
阴雨天过后出太阳	重见天日；开云见日
阴雨天拉稻草	越拖越重
寅时点兵，卯时上阵	说干就干
淫妇唱淫曲	不堪入耳
银锤打在金锣上	一声更比一声响
银锤对金锣	一个赛一个
银盆打水金盆装	原谅（圆亮）
银线穿金线	两相配
银行的支票	扯不得；莫扯
银行里发的白纸条	空头支票
银样锻（la焊锡）枪头	中看不中用
银圆当镜子	认钱不认人；一切向钱看
引狼人室	不顾后患；自招灾祸；自取灭亡
饮酒止渴	自取灭亡
饮鸩（zhen 鸩酒。剧毒）止渴	自取灭亡
婴儿饿肚皮	有奶便是娘
鹦哥唱大曲	巧上加巧
鹦鹉的嘴巴	会说不会做
鹦鹉学舌	人云亦云
鹦鹉遇见百灵鸟	又说又唱；说说唱唱
鹰饱不抓兔，兔饱不出窝	懒对懒
鹰飞蓝天，狐走夜路	各走各的路
鹰飞蓝天，走夜路	各走各的道
鹰嘴里夺兔，猫嘴里夺鱼	难下手；下不了手；无法下手
鹰嘴鸭巴掌	能吃不能拿
迎风吐唾沫	自作自受
萤火虫的屁股	没多大亮
萤火虫斗架	明打明
蝇子放屁	吓唬哪个
蝇子见了血	走不动
赢得猫儿输了牛	因小失大
硬按公鸡下蛋	指望不上
硬棒槌弹棉花	越弹越乱
硬汉子卖豆腐	人强货不硬
硬拿乌龟当神供	不识鳖
硬牛皮	看你咋吹
硬要麻雀生鹅蛋	蛮不讲理
勇士上刺刀	拼杀一场
用秕糠（bi kang 秕子和糠）垒水坝	无济于事
用茶杯饮骆驼	无济于事；不济事
用床单洗脸	大方
用刺锥牛	无关痛痒；不痛不痒
用斗量糠	不声不响
用筷子穿针眼	难啊
用力吹网兜	白费劲；枉费工
用了三代的钉耙	无耻（齿）
用人家的火做自家的饭	爱占便宜
用小虾钓鲤鱼	吃小亏占大便宜
邮包掉水田	半信半疑（泥）
邮包上挂灯草	轻信
邮递员进门	带信儿的来了
油灯上炖猪蹄	慢慢来
油干灯草尽	说灭就灭；奄奄一息（熄）
油壶里打跟头	胡（壶）闹
油画里卷国画	话（画）里有话（画）
油煎冰棒	一场空
油库着了火	难近身；近不得身
油篓里的西瓜	又圆又滑
油篓里掷骰子	没跑；跑不了
油瓶当鼓槌	空对空
油漆匠的家当	有两把刷子
油条泡汤	软瘫了
油盐罐子	形影相随；一对儿
油炸臭豆腐	闻着臭，吃着香
油炸花生米	干脆；干干脆脆
油炸辣椒	够戗（够受的）
油炸麻花	干干脆脆；全身都酥了
蚰蜒吃萤火虫	心里明白
游方的道士	四海为家
游僧撵（nian 驱逐；赶走）住僧	喧宾夺主
游泳池里垂钓	引人上钩
游泳池里撒网	一无所获
有北屋，有南墙	不成东西
有尺水，行尺船	量力而行
有福同享，有祸同当	同甘共苦
有理三扁担，无理扁担三	不分青红皂白；分不清青红皂白
有了五谷想六谷	贪心不足
有了一福想二福，有了肉：吃嫌豆腐	贪得无厌
有骆驼不讲牛羊	光拣大的说
有马不骑，有车不坐	练腿劲
有钱人家的看门狗	势利眼
有人喜欢淡，有人喜欢咸	各对口味
有人喜欢鸡，有人喜欢鸭	各有所爱
有西瓜不讲芝麻	光拣大的说
有衣无帽	不成一套
有枣无枣三竿子	乱打一通
又办丧事又嫁女	一番欢喜一番愁
又扮巫婆又装鬼	两面讨好
又打收兵锣，又吹冲锋号	进退两难
又敲锣鼓又放炮	想（响）到一块了
又娶媳妇又嫁女	双喜临门
又想要公羊，又盼有奶喝	贪得无厌；难两全
又咒天子又骂娘	不忠不孝
又抓糍粑（ci ba）又抓面	难脱手
又做端公（男巫师）又做鬼	两面讨好
又做巫婆又做鬼	两面装好人
鱼刺卡喉咙	进不去，出不来；吞不下，吐不出
鱼大吃虾，虾大吃鱼	弱肉强食
鱼儿得水，鸟儿人林	自由自在
鱼儿钻进网眼里	进退两难
鱼钩抛在河中心	放长线钓大鱼
鱼口里的水	吞吞吐吐
鱼篓里的螃蟹	进来容易出去难
鱼苗放大海	各散四方
鱼盆里的螃蟹	你算哪一路
鱼吞香饵	不知有钩
鱼网挡太阳	难遮盖
鱼网里的山鸡	有翅难飞
鱼鹰下洞庭	大有作为
鱼游锅中	好景不长
鱼找鱼，虾找虾，乌龟爱王八	气味相投
俞伯牙摔琴	不谈（弹）了
渔场失火	枉然（网燃）
渔船上打儿子	跑不了
渔夫赶上鱼汛，猎手赶上兽群	喜之不尽
渔夫听到渔汛、猎手赶上兽群	喜之不尽
渔鼓艺人打鼓帮	敲竹杠
渔篮子提水	没一处不是漏子
渔网当伞	遮不住阳光
愚公的住处	开门见山
愚公移山	非一日之功
榆木疙瘩	难劈；不开窍；难开窍
榆木疙瘩脑袋	死硬
羽毛扇打孩子	无关痛痒；不痛不痒
羽毛扇扑火	惹火烧身；引火烧身
雨点落在香头上	巧得很；巧极了
雨后的彩虹	五光十色
雨后的高梁苗	直往上蹿
雨后的花园	万紫千红
雨后的竹笋	节节高；节节上升
雨后收葱	连根拔
雨后送伞	多此一举；空头人情；假仁假义；虚情假意
雨花台的石子	五光十色
雨浇泥菩萨	土里土气；土气大
雨天背稻草	越背越重
玉帝的手书落人间	泄露了天机
玉帝娶亲，阎王嫁女	欢天喜地
玉帝娶亲	天大喜事
玉帝讨河神	尽是天兵天将
玉帝下请帖	天大的好事
玉帝爷出告示	神话
玉帝爷的帽子	宝贝疙瘩
玉帝爷嘴上拔胡子	胆大包天
玉皇大帝拜财神	有钱大三辈
玉皇大帝吃稀饭	装穷
玉皇大帝打跟头	天翻地覆
玉皇大帝讲天书	空谈
玉皇大帝娶土地婆	惊天动地
玉皇大帝做媒	天作之合
玉皇爷出征	大动干戈；尽是天兵天将
玉米地里带绿豆	杂种
玉米秸里的虫	专（钻）心
玉米开花	顶上见
玉米棵上戴凉帽	凑人头
玉米粥里落土鳖	糊涂蛋
玉器涂白漆	内中有宝；内贵外贱；多余；装贱
玉石店里的珍品	精雕细刻
玉石娃娃	宝贝蛋
玉石烟袋	好嘴
玉匣记做枕头	痴人说梦
芋头叶上的水珠	滚了
芋头叶子当钹（bo打击乐器）敲	不堪一击
育公打灯笼	照见别人，照不见自己；照人不照己
浴室里的灯	模模糊糊
预备腊肉待亲家	久有意
遇到老翁叫大哥	没大没小
遇见王母娘娘叫大姑	想高攀
鸳鸯戏水	成双成对
鸳鸯一对儿	两相配
箢篼（yuan dou盛东西的器具。用竹篾等编成）抬狗	不受人尊重
元旦出门除夕回	满载而归
元旦翻日历	头一回；头一遭
元宵掉进糨糊盆	糊涂蛋
元宵掉进肉锅里	说他混蛋，他还心里甜
元宵里裹爆竹	糖衣炮弹
园里的橡胶树	任人千刀万剐
园里挑瓜	越选越差
园艺师的手艺	移花接木
园中的韭菜	你算哪一蔸
园子里的辣椒	红到顶了
原子弹爆炸	不同凡响；一鸣惊人
原子弹炸鸟	大材小用
圆的做盖盖，方的做牌牌	各有用场
圆顶帐子	没门；无门
圆珠笔蘸墨水	多事
袁世凯当皇帝	短命的货
袁世凯当皇上	好景不长
远地得家书	陡增欢喜
远路人蹬水	不知深浅
远洋轮出海	外行（航）
院子里搭戏台	有戏唱啦
院子里挖陷阱	坑到家了
月光下散步	形影相随
月亮坝摆龙门阵	明说明讲；明说
月亮坝里点灯	多此一举
月亮坝里耍弯刀	明砍
月亮坝里掷色子	观点模糊
月亮地里晒被单	白搭
月亮地里晒谷子	阴干；将就天
月亮跟着太阳转	沾光；借光
月亮里的桂树	高不可攀
月亮下点油灯	多事
月缺花残掉眼泪	触景生情
月下老人绣鸳鸯	穿针引线
月月红裹在绸缎里	锦上添花
月子婆娘挨打	不近人情
钥匙插进锁孔里	开窍了
钥匙挂胸口	开心
钥匙挂在眉梢上	开眼界
阅览室里翻报纸	大有文章
云彩里摆手	高招
云彩里盖大厦	空中楼阁
云端摘日，海底捞月	痴心妄想
云缝里的日头	毒极了；最毒
云里的浪花	高潮
云南的老虎，蒙古的骆驼	谁也不认谁
云头里帖告示	空话连篇
云头上打靶	放空炮
云头上翻跟头	武艺高；本领高；没着落
孕妇过独木桥	铤（挺）而走险
运动员下跑场	你追我赶
运碓窝（dui wo石臼）的翻了船	石沉大海
熨斗烫衣服	服服帖帖
杂草包黄鳝	溜啦
杂货店的买卖	挑挑拣拣
杂货铺的掌柜	见钱眼开
杂货铺关门	没货了
杂货铺里卖棺材	无奇不有；死活都赚钱
杂货铺卸货	没进步（布）
杂货铺子	无所不有
杂技表演	硬功夫；绝招
杂技团里的空竹	抖起来了
杂技团里的小丑	尽走过场
杂技团里的演员	各有拿手好戏
杂交的骡子	非驴非马
杂耍班子走江湖	逢场作戏
砸锅卖铁	一锤子买卖；豁出去了
砸开的核桃	有人（仁）儿
砸烂了的西瓜	红白相杂
砸子锅碗搬了灶	散伙（火）
栽完树就想乘凉	急性子
宰鹌鹑也要请屠夫操刀	小题大做
宰个鸽子也要请屠夫提刀	小题大作
宰相的千金	不愁嫁不出去
宰相的千金皇帝的女	不怕没人要
宰相门第元帅府	门当户对
糌粑（xan ba青稞麦炒熟后磨成的面）拌白糖	又甜又香
糌粑糊了嘴	闷了口
脏水倒阴沟	同流合污
脏水灌到茅坑里	越闹越臭
脏水罐子掉到茅坑里	越闹越臭
脏拖布擦地板	不干不净
葬瓶里的骨灰	是不自由的鬼
糟鼻子不吃酒	枉担其名
早餐啃馒头	一口一口地吃
早晨吃晌午	打破常规
早晨的露水	见不得阳光；不久长；难长久
早晨的天，婆婆的脸	说变就变；转眼就变；变化无常
早春的桃花	红不久
早开的红梅	一枝独秀
早起开门窗	换换空气
早起碰见抬轿的	出门见喜
早日里的泥鳅	钻得深
早上的林中鸟	各唱各的调
早天刮西北风	干吹
枣骨子（枣核）解板	不是正经材料
枣核搭牌楼	针锋相对；奸（尖）对奸（尖）
枣核儿解板	没有几句（锯）
枣木梆子	一对儿；不打不响；一辈子挨打；挨敲打的货
枣木疙瘩	不开窍
枣木做烧柴	难劈
枣子骨头	两头奸（尖）
澡堂里的油灯	气昏了
灶边的磨子	推一推，动一动
灶房里的砧板	油透了
灶火坑里烧山药	吃里爬（扒）外
灶君（灶神）帖腿上	人走家搬
灶坑插杨柳	死不死，活不活；要死不活
灶坑里扒红薯	拣软的捏
灶坑里烧王八	憋气又窝火
灶里煨红薯	不到熟透不外掏
灶门口栽杨树	活不久；活不长
灶门前的烧火棍子	焦头烂额
灶门前干活	煽（扇）风点火
灶门前拿竹筒	吹了
灶旁的风箱	扇风点火
灶前老虎	屋里凶
灶上的炒勺	尝尽了酸甜苦辣
灶上的抹布	酸甜苦辣尝尽了
灶神上贴门神	话（画）里有话（画）
灶神爷跑到院里	多管闲事
灶台上的抹布	揩油；沾油水
灶膛里抡锤子	砸锅
灶王爷不在家	没主事的人
灶王爷吹灯	好神气
灶王爷打飞脚	离板了
灶王爷打跟头	砸锅了
灶王爷的横批	一家之主
灶王爷跌到锅里	蒸神
灶王爷跌跟头	砸锅了
灶王爷放屁	神气
灶王爷扔石头	砸锅
灶王爷扫院子	多管闲事
灶王爷上天	尽说吉利话；有一句说一句；有啥说啥；神气（起）来了；走了神；走神；尽说好话；好言在先
灶王爷贴在腿肚上	人走家散
灶王爷贴在腿肚子上	人走家搬；搬家
造屋请箍桶匠	找错人啦
贼被狗咬	干吃哑巴亏；难出口；不好声张
贼去了才关门	错过时机；晚了
贼上房送梯子	头号帮凶
贼娃子进铁匠铺	倒贴（盗铁）
贼娃子拾东西	不是偷也是偷
贼娃子说梦话	不打自招；想偷
贼娃子㈠、偷）打官司	场场输
曾老九的弟弟	真老实（十）
增一分太长，减一分太短	恰到好处；正好；恰好；刚好
赠马赠笼头	好事做到底
扎鞋不拴绳结	半途而废
铡刀锄地	管得宽
铡刀剃秃头	拿着脑袋瓜子玩；硬拿脑袋开玩笑
铡刀下伸驴头	刀下找食
眨巴眼养个瞎儿子	一辈不如一辈；一代不如一代
眨眼打哈欠	扬眉吐气
炸了窝的马蜂	乱哄哄
炸麻花的碰上搓草绳的	擦劲儿（biao jin er双方因赌气或竞赛等憋着劲比着（干））；较劲
炸蠕斗公鸡	玩命
炸响了的炮仗（爆竹）	四分五裂
炸药的捻子	一点就着；点火就着
炸药库里玩火	万万不可
炸油饼的卖冰棍	冷热结合
蚱蜢碰上鸡	在劫难逃
蚱蜢撞车轮	粉身碎骨
斋公丢腊肉	难开口；不好开口；不好声张
摘到果子捧伤腿	得不偿失
摘到果子摔伤腿	得不偿失
摘樱桃爬到柳树上	白忙活；白忙一场
宅院修在城墙上	闹中取静
债主找到了负债的	清了吧
毡匠擀毡	厚此薄彼
毡袜裹脚靴	寸步不离；离不开
毡子上拔毛	不显眼
粘牙的烧饼	面生
粘牙的烧饼一	面生
展览会上的陈列品	样子货
战场上用兵	虚虚实实
战士出征	打上前去
战争贩子唱和平	趁机磨刀；口蜜腹剑
站在岸边看翻船	见死不救
站在草席上比高低	高也有限
站在房顶跳伞	水平太低
站在高山看打架	袖手旁观
站在高山看大海	远水不解近渴
站在海边打咳声	望洋兴叹
站在海边看鱼跳	干瞪眼
站在海滩望大海	宽大无边
站在河岸捞月亮	白搭工
站在河边撒尿	随大流
站在河边撒屎	随大流（比喻跟着多数人说话或行事。）
站在山顶赶大车	鞭长莫及
站在山上看马斗	踢不着，咬不着（比喻不参与一些事，只站在旁边观望。）
站在远洋轮上讲怪话	海外奇谈
站在云头吊嗓子	唱高调
站着身子正	不怕影儿斜
蘸（zhan）了汽油的稻草	一点就着；点火就着
蘸了汽油的柴禾	一点就着
蘸水钢笔	没有胆
蘸雪吃冬瓜	淡而无味
蘸着稀饭吃扁食（饺子）	越吃越糊涂
张飞摆屠案	凶神恶熬（杀）
张飞唱曲子	粗声粗气
张飞撤退长坂坡	过河拆桥
张飞吃秤砣	铁了心、
张飞吃豆芽	小菜一碟；小菜儿
张飞穿针	粗中有细；大眼瞪小眼；有劲无处使
张飞打岳飞	乱了朝代
张飞当县官	能文能武；文武双全
张飞剁肉馅	大材小用
张飞翻脸	吹胡子瞪眼
张飞贩私盐	谁敢检查
张飞哈气	自我吹虚（须）
张飞看地老鼠	大眼瞪小眼
张飞嗑瓜子	不够塞牙缝；不够嚼
张飞妈妈姓吴	无事（吴氏）生非（飞）
张飞卖秤锤	人强货硬
张飞卖刺猥	人强货扎手
张飞卖豆腐	人强货不硬；黑白分明
张飞卖肉	一刀切
张飞卖铁锤	人硬货了当
张飞卖针	人强货扎手
张飞拿耗子	大眼瞪小眼
张飞骑老虎	人强马壮
张飞纫针（ren zhen引线穿过针鼻儿）	大眼瞪小眼；粗中有细
张飞扔鸡毛	有劲难使
张飞上阵	横冲直撞
张飞使计谋	粗中有细
张飞耍扛子	轻而易举
张飞讨债	气势汹汹
张飞绣花	粗中有细；力不从心；心有余而力不足；不对劲
张飞遇李逵	黑对黑；黑上加黑
张飞战关公	忘了旧情；不念旧情
张飞战马超	不分胜负
张飞抓耪子	大眼瞪小眼
张公帽掇（duo拿）在李公头上	张冠李戴
张果老倒骑驴	背道而驰；不见畜牲面；往后看
张果老骑驴	倒着走
张果老骑毛驴	倒行逆施
张果佬倒骑毛驴	向后看；越走越远
张家的儿子李家养	大有名堂
张家的老绝户，李家的老寡妇	孤的孤；苦的苦
张了网就走	撒手不管
张驴儿（戏曲《窦娥冤》中人物）告状	冤枉好人；肚里有鬼；心怀鬼胎
张驴儿上公堂	恶人先告状
张木匠拉锯	有来有去；有来有往
张三（狼的俗称）不吃死孩子	活人惯的
张三和大虫（老虎）抢食	狼吞虎咽
张三哄孩子	没安好心
张生的病	吃药没用
张生回头望莺莺	恋恋不舍
张生碰着崔鸳鸯	一见钟情
张生跳粉墙	偷花贼
张生遇见崔莺莺	一见钟情
张顺浪里斗李逵	以长攻短
张思德烧炭	全心全意
张天师被鬼降住了	无法可使；有法难使
张天师被鬼迷住	明人也有糊涂时
张天师得了哑病	没咒念
张天师贩寿星	倚（以）老卖老
张天师画符	玩的骗人术
张天师家闹鬼	不足信；信不得
张天师叫门	内中有鬼
张天师设祭坛	呼风唤雨
张天师失去了五雷印（据说张天师手中的武器能发雷镇妖）	无法
张天师卧病在床	不可救药
张天师戏何仙姑	两厢情愿
张天师下凡	降妖拿怪
张天师下海	莫（摸）怪
张天师捉妖	拿手好戏
张小泉的剪刀	名不虚传
蟑螂落油锅	全身都酥了
掌磅秤的报数儿	句句有分量；句句实话
掌钳的敲小锤	正在火候上
丈八房子，丈九菩萨	出了头
丈八高的灯台	照远不照近；照见别人，照不见自己；照人不照己
丈八罗汉	摸不着头脑
丈二长的扁担	摸不清头尾
丈二长的水烟袋	分不清头尾
丈二的斗笠	高帽子
丈二高的门槛	难进
丈二和尚	摸不着头脑
丈二厚的屋基	根底深
丈二金刚	摸不着头脑
丈二金刚扫地	大手大脚
丈二宽的长袍	大摇（腰）大摆
丈二宽的大褂	大摇（腰）大摆
丈夫不打妻子	好福气（夫妻）
丈夫坟头哭爹妈	上错了坟
丈母娘跺脚	后悔已晚；为时已晚
丈母娘看女婿	越看越欢喜
丈母娘夸姑爷	好得很
丈母娘瞧女婿	越看越欢喜；越看越顺眼
丈母娘疼女婿	人情人理；诚心实意
丈母娘遇亲家母	婆婆妈妈
丈人瞧见傻女婿	越看越惹气
招牌上挂马桶	臭名远扬
招亲招来猪八戒	自找难看；自讨难看
找擀杖摸到牛犄角	别扭出穹儿来了
找个姑娘当媒人	不成也有点希望
找木匠补锅	找错了人
沼泽地里的推土机	拖泥带水
赵公元帅翻脸	不认账
赵公元帅拍肩膀	好事临头
赵匡胤穿龙袍	改朝换代
赵匡胤卖包子	御驾亲征（蒸）
赵匡胤押江山	大赌
赵括（战国时赵国名将赵奢之子）讲兵法	夸夸其谈
赵括徒读父书	纸上谈兵
赵孙李	没钱
赵五娘“琵琶记》中人物）上京	一路辛苦
赵五娘写家书	难字当头
赵云大战长坂坡	大显神威
赵云摔阿斗	收买人心
赵子龙上阵	百战百胜；单枪匹马
照葫芦画瓢	按老样子做（比喻单纯模仿，不加改变。）
照猫画虎	差不离
照明弹上天	高明
照相的底片	颠倒黑白
照相馆改底片	羞（修）人
照着葫芦画瓢	全盘照搬
照着镜子作揖	自己拜自己
针尖对麦芒	针锋相对；奸（尖）对奸（尖）
针尖对枣圪针（go zhen某些植物枝梗上的刺儿）	一个比一个尖；尖对尖
针尖上擦油	又尖又滑
针尖上落灰	微不足道；微乎其微
针尖上落芝麻	难得；得之不易；难顶
针尖上削铁	难得；细索求；有也不多
针挑黄连	挖苦
针挑手中刺	一个更比一个尖
针无两头尖	难得两全
针眼里观景致	一孔之见
针眼里看人	小瞧
针毡上睡觉	坐卧不宁
侦察员破案	暗中活动
珍珠搀到绿豆里卖	屈才（财）；一样价钱两样货
珍珠打麻雀	得不偿失
珍珠落玉盘	哨哨枸；响哨哨
珍珠没眼儿	瞎宝贝
砧板上的蚂蚁	刀下找食
砧板上的肉	该剁；任人宰割
枕边言语骨边肉	人人喜欢
枕木上的铁轨	明摆着
枕着扁担睡觉	想得宽
枕着卷子（一种面食品）睡觉	不愁吃
枕着竹筒睡大觉	空头空脑；空想；空做梦
阵拷的徒弟	好睡
睁眼打呼噜	昏头昏脑；昏了头
睁眼瞎看告示	两眼墨黑
睁眼瞎考状元	丢人现眼
睁眼瞎老装元	丢人现眼
蒸酒熬糖	各干一行
蒸馏塔上迈步	无路可走
蒸笼盖子	受不完的气
蒸笼里的馒头	自我膨胀
蒸笼里伸出个头来	熟人
蒸馍打狗	有去无回
蒸熟的鸭子	飞不了
蒸鱼不沾水	全凭一口气
整筐丢西瓜，满地拾芝麻	大处不算小处算
正月初一过生日	双喜临门
正月初一见明月	机会难得
正月初一卖门神	过时货；没人过问
正月初一捧元宵	只只好；个个好
正月间走亲戚	礼尚往来；有来有往
正月里生，腊月里死	两头忙
正月十五才拜年	晚了半月
正月十五打灯笼	年年都一样
正月十五打牙祭（偶尔吃顿丰盛的饭）	一年一回
正月十五的龙灯	任人耍；由人玩耍
正月十五的月亮	光明正大
正月十五的走马灯	反复无常
正月十五放烟火	好景不长
正月十五赶庙会	随大流
正月十五看花灯	走着瞧
正月十五卖元宵	抱成团
正月十五贴春联	晚了半月了
正月十五贴门神	晚了半月
正月十五云遮月	不露脸
芝麻地里长苞米	高低不齐
芝麻地里长黄豆	杂种
芝麻地里打锣	敲到点子上
芝麻地里的黄豆	数它最大（比喻显示自己有能耐）
芝麻地里的烂西瓜	数你大
芝麻地里的老鼠	吃香
芝麻地里种西瓜	有大有小
芝麻堆里藏西瓜	小中见大
芝麻秆做门闩	不能推敲
芝麻开花	节节高；节节上升
芝麻里加虱子	乱搀和
芝麻脸儿	好大的脸皮
芝麻落在针眼里	巧极了；凑巧了；赶得巧；正好
芝麻做饼	点子不少
芝庶地里的老鼠	吃香
知了落在粘竿上	自投罗网
知县跌粪坑	赃（脏）官
织布不用梭子	就靠吹（比喻人既有心眼，又极油滑不老实）
织布机上的梭子	两头窜
织女配牛郎	欢天喜地；天作之合
蜘蛛摆下八卦阵	专捉飞来将
蜘蛛结网，耗子打洞	各有各的主意
蜘蛛拉网	七勾八扯
直巷赶狗	回头一口
直性人发言	一有啥说啥
止着耳朵腮也动	互相牵连
只尝不买	光占便宜
只顾烧火，忘了翻锅	一处不到一处乱
只说不练的把势	光耍嘴
址起风帆又蔼桨	有福不会享
纸补裤裆	越补越烂
纸船出海	经不起风浪
纸糊的背墙	靠不住
纸糊的窗户	一点就破（比喻一经指点就明白）
纸糊的窗子	一点就透；一戳就破
纸糊的大鼓	不堪一击
纸糊的大炮	一辈子也打不晌
纸糊的灯笼被雨浇	架子不倒
纸糊的灯笼	心里明；一捅就破
纸糊的房子	不能容人；不是安身之处
纸糊的棺材	哄鬼；骗鬼；坑死人
纸糊的喇叭	吹不得；别吹了
纸糊的栏杆	靠不住；不可靠
纸糊的老虎	吓不住人；不堪一击；不咬人
纸糊的驴	大嗓门儿
纸糊的琵琶	谈（弹）不得；无法谈（弹）
纸糊的墙	靠不住
纸糊的拳头	轻而易举
纸糊的人过河	衣烂架不到
纸糊的扇车	担风险
纸糊的洋娃娃	肚里空
纸糊的月亮当太阳	偷天换日
纸老虎	一戳就穿
纸马店的货	等着烧
纸上画刀	无关痛痒
纸做的花	无结果
纸做的伞	不顶用
指甲离肉	痛不可言
指甲肉里扎刺	受不了
指着秃子骂和尚	借题发挥
掷瓜捡豆	因小失大
中国的功夫	名不虚传
中了状元招驸马	好事成双；喜上加喜
中秋的天气	不冷不热
中秋过了闰八月	团圆过了又团圆
中秋节的月亮	光明正大
中秋节赏桂花	花好月圆
中山狼出了书袋子	凶相毕露
中式服装西式领	独出心裁
中堂里夹条幅	话（画）里有话（画）
中药铺的家伙	不拘一格
终身当会计	长期打算
钟表里的摆	左右不定；摇摆不定
钟鼓楼上摆肉案	架子不小；好大的架子
钟鼓楼上的麻雀	耐惊耐怕；吓大了胆
钟鼓搂上百灵鸟	惊不出来
钟馗（kui）打饱嗝	肚里有鬼
钟馗打饱嗝	肚里有鬼
钟馗嫁妹	鬼混（婚）
钟馗开饭店	鬼不上门
钟馗受骗	被鬼迷往
钟馗爷站十字路口	四下拿邪
种地不出苗	坏种
种黄连的和尚	苦师傅
种马见了牝马（pin ma雌马）	抖起来了
种下碗豆收荞麦	长出棱角来了
众人的嘴	捂不住
重锤打锣	哨哨响¨向哨哨
重锤掉在钢板上	落地有声
重阳节上山	登高望远；站得高，看得远
周郎妙计安天下	赔了夫人又折兵
周瑜打黄盖	两厢情意；装模作样；自家人打自家人；一个愿打，一个愿挨；装样子
周瑜讨荆州	费力不讨好
粥锅里煮蚯蚓	糊涂虫
妯娌（zhou li）赶集	同奔前程；一路
朱德的扁担	有名有姓
珠穆朗玛峰上点灯	高招（照）；高明
珠穆朗玛峰上听鸡叫	高调
诸葛亮草船借箭	有借无还
诸葛亮唱空城计	急办法
诸葛亮弹琴	计上心来
诸葛亮当军师	足智多谋；名副其实
诸葛亮的丑妻	家中宝
诸葛亮的鹅毛扇	神妙莫测
诸葛亮的锦囊	用不完的计
诸葛亮吊孝	假仁假义
诸葛亮放盂获	欲擒故纵
诸葛亮焚香操琴	故弄玄虚
诸葛亮挥泪斩马谡	顾全大局
诸葛亮借东风	将计就计；金蝉脱壳
诸葛亮三次周瑜	略使小计
诸葛亮三气周瑜	略使小技
诸葛亮玩狗	聪明一世，糊涂一时
诸葛亮用空城计	不得己
诸葛亮斩马谡（su）	执法如山；不念旧情
诸葛亮战群儒	全凭一张嘴
诸葛亮征孟获	收收放放
诸葛亮治蜀	顺应民心
猪八戒败阵	倒打一耙
猪八戒扮新娘	好歹不像；其貌不扬
猪八戒背媳妇	吃力不讨好；费劲不落好；上当受骗
猪八戒不成仙	吃了嘴的亏；全坏在嘴上
猪八戒搽粉	自以为美；遮不了丑
猪八戒吃炒肝	自残骨肉
猪八戒吃大肉	忘本
猪八戒吃核桃	囫囵（hu lun完整；整个儿）吞
猪八戒吃黄连	苦了大嘴的
猪八戒吃面条	粗中有细；狼吞虎咽
猪八戒吃人参果	囫囵吞；不知贵贱；食而不知其味；全不知滋味
猪八戒吃西瓜	独吞
猪八戒吃胰子（yi zi肥皂）	内秀（锈）；秀（锈）气在内
猪八戒吃猪啼	自残骨肉
猪八戒充英雄	只是嘴皮子拱得欢
猪八戒吹牛	大嘴说大话
猪八戒打蚂蚱	笨手笨脚
猪八戒戴耳环	自以为美
猪八戒戴花	自我欣赏；不知自丑
猪八戒戴眼镜	冒充斯文；假斯文
猪八戒的武艺	倒打一耙
猪八戒的嘴巴	自我欣赏
猪八戒的嘴	贪吃贪喝；饱吃饱喝
猪八戒调戏白骨精	自上圈套
猪八戒掉到泔水桶里	大吃大喝
猪八戒掉进万花筒	丑态百出
猪八戒读诗文	冒充圣人
猪八戒拱帘子	嘴先进
猪八戒逛公园	不够格
猪八戒过火焰山	倒把一耙
猪八戒喝恶水（泔水）	各有各的口味；各对口味
猪八戒喝磨刀水	内秀（锈）；秀（锈）气在内
猪八戒结亲	一个喜来一个忧；喜的喜，忧的忧
猪八戒进了女儿国	看花了眼；神魂颠倒；不想走了
猪八戒进屠场	自己贡献自己
猪八戒啃地梨	什么仙人吃什么果
猪八戒啃猪蹄	忘了自个儿姓名；自残骨肉
猪八戒挎腰刀	邋遢（la ta不整洁）兵
猪八戒了天拜佛	掸心不稳
猪八戒抡家伙	倒打一耙
猪八戒买猪肝	难得心肠
猪八戒卖炒肝	这是哪道肺
猪八戒卖凉粉	人丑名堂多
猪八戒娶媳妇	痴心妄想
猪八戒三十六变	没有一副好嘴脸
猪八戒耍把式	倒打一耙
猪八戒摔镜子	怕露丑
猪八戒甩耙子	不干了；不伺侯（猴）
猪八戒投胎	走错了门；找错了门
猪八戒西天取经	三心二意
猪八戒相亲	怕露嘴脸
猪八戒笑孙猴	不知自丑
猪八戒绣花	粗中有细
猪八戒招亲	黑灯黑人
猪八戒照镜子	里外不是人
猪八戒照像	自找难堪（看）
猪八戒坐班房	不白之冤
猪八戒做梦娶媳妇	尽想好事；想得倒美
猪鼻子插大葱	装相（象）
猪大肠	扶不起来
猪苦胆泡黄连	苦上加苦
猪苦胆扔井里	苦得深
猪猡（猪）出痘子	肉麻
猪脑壳做枕头	昏（荤）头昏（荤）脑
猪尿脬（sui pao膀胱）打不死人	气胀人
猪尿脬打人	打不死，臊也臊死了
猪尿脬上扎刀子	泄气了；气放了；泄了气
猪尿脬上扎一刀	气消了
猪尿泡打人	情节重
猪婆吃包衣	自吃自
猪圈里的黄牛	高人一头
猪圈里养骆驼	突出
猪肉锅里捞豆腐	黑白分明
猪肉汤洗澡	腻死人
猪身上的肉	有肥有瘦
猪蹄子不放盐	一旦（淡）角（脚）
猪头挂在花椒树上	肉麻
猪头抹黄连	苦恼（脑）
猪往前拱，鸡往后扒	各有各的门道；各有各的路
猪向前拱，鸡住后刨	各有各的门道
猪血煮豆腐	黑白分明；混淆黑白
猪鬃刷子	又粗又硬
猪鬃拴豆腐	没法提；提不得；别提了
猪嘴里挖泥鳅	死也挖不出来
竹虫咬断竹根	同归于尽
竹竿撑舰艇	划不来
竹竿打锣	有节奏
竹竿打水平平过	不分高低
竹竿打月亮	挨不上
竹竿顶天	差一大截儿
竹竿赶鸭子	呱呱叫
竹竿敲竹筒	空想（响）
竹竿榨油	压不出
竹竿子搭桥	难过
竹管里看天	所见不广
竹筐挑水	两头空；两落空
竹篮打水风拦风	全落空
竹篮打水	一场空；枉费功
竹篮盛稀饭	漏洞百出
竹篱笆墙抹石灰	外光里不光；表面光
竹林里的凤凰	有翅难飞
竹林里放纸鸢	胡搅蛮缠
竹林里挂灯笼	高风亮节
竹林里栽柏树	亲（青）上加亲（青）
竹篓里的泥鳅	没跑；跑不了
竹篾绑竹子	自己捆自己
竹篾穿黄鳝	串起来了
竹篾里捉螃蟹	十拿九稳；手到擒来
竹筛子兜水	漏洞百出
竹筛子做锅盖	心眼多；心眼不少
竹筒沉水	自满自足
竹筒倒豆子	干脆利索；不藏不掖（ye塞进（衣袋或夹缝里））；一个不留；一干二净；全抖出来
竹筒倒豌豆	一干二净
竹筒里插棍子	直来直去；直进直出
竹筒里点灯	照管
竹筒里爬长虫（蛇）	直出直入
竹筒里跑老鼠	直来直去；直进直出
竹筒敲鼓	空对空
竹筒子吹火	只有一个心眼
竹筒子里看天	一孔之见；所见不广
竹筒子里塞棉花	空虚
竹筒做枕头	两头空；两落空；空想
竹枕头	空的
竹子扁担挑竹筐	碰上自家人
竹子长杈	节外生枝；横生枝节
竹子当鼓	敲竹杠
竹子上结南瓜	怪事一桩；怪事
竹子做笛	受不完的气
拄拐棍走泥路	步步有点
拄着拐棍下煤窑	倒霉（捣煤）
渚葛亮用兵	出奇制胜；神机妙算；虚虚实实；神出鬼没
属扒火棍的	一头冷来一头热
属芭蕉的	叶烂皮干心不死
属比目鱼的	成双成对
属长虫（蛇）的	能屈能伸
属臭豆腐的	闻着臭，吃着香
属大肚罗汉的	睁只眼，闭只眼
属豆饼的	上挤下压
属舵鸟的	顾头不顾尾
属公鸡的	好斗；光叫唤；不下蛋
属狗尾巴的	越摸越翘
属含羞草的	碰不得
属寒号鸟的	得过且过
属豪猪的	浑身是刺
属耗子的	胆子小；偷吃偷喝
属黑瞎子（狗熊）的	吃饱就睡；光认吃
属济公的	疯疯癫癫
属老母猪的	吃饱就睡
属雷管的	碰不得
属吕布的	有勇无谋
属泥鳅的	圆滑；又圆又滑
属暖水瓶的	外冷里热
属螃蟹的	横行霸（八）道
属炮筒子的	直来直去
属皮球的	踢来踢去
属生姜的	越老越辣
属孙猴的	说变就变；转眼就变
属乌龟的	缩头缩脑
属牙膏的	受人排挤；不挤不出
属张飞的	粗中有细
属珍珠鱼的	浑身尽点子
属猪八戒的	好吃懒做
属竹子的	心虚
煮坏的饺子	露馅了
煮熟的饭不吃	闷（焖）起来了
煮熟的鸭子	飞不了
煮熟的鸭子飞上了天	弥天大谎；天下奇闻；怪事一桩
煮熟的鸭子飞上天	弥天大谎
苎里的马蜂	不是好惹的；惹不起
蛀虫咬黄连	自讨苦吃
蛀虫钻空大树心	暗里使坏
抓把红土当朱砂	不识货
抓把兔子草喂骆驼	不是好料
抓把朱砂当红土	装贱
抓地坑沟找豆包吃	没出息
抓了芝麻丢西瓜	主次不分
抓起红土当朱砂	做了糊涂事
抓住鼓槌子不放手	老敲打
抓住荷叶摸到藕	追根求源；追根到底
抓住渔船当鞋穿	大手大脚
抓住张飞当李逵打	认错了人
拽（zhuai拉）着大嫂叫姑姑	拉扯不上
拽着胡子走路	谦虚（牵须）
拽着老虎尾巴抖威风	有胆有魄
砖头上钉钉子	过得硬；逗硬
砖窑里起火	谣言（窑烟）
砖窑旁边盖楼房	就地取材
庄户人家的孩子	土生土长
庄稼汉爬梯田	步步高升；步步登高
庄稼老不识桂圆	外行（黄）
庄稼老汉背木掀	扬长（场）而去
庄稼老看告示	一篇大道理
庄稼人种豆子	步步有点
庄稼人种五谷	土生土长
庄稼人走亲戚	实来实去
状元府内吃蟠桃	贵人吃贵物
撞网的大头鱼	晕头转向
追击炮打蚊子	小题大作（比喻把小事当作大事来对待、处理。）
锥子藏在铁盒里	不露锋芒
锥子上抹油	又尖又滑
锥子剃头	连根拔
锥子扎豆腐	不出白
捉了虱子跑了牛	得不偿失
捉虱子上头	自寻烦恼；自找麻烦
捉鱼拦上游	先下手
捉住驴子当马骑	不识货
桌上拉屎，脸盆里撒尿	净干缺德事
桌子板凳一样高	平起平坐
桌子底下打拳	出手不高
桌子底下扬场	碍上碍下；碰上碰下
桌子光剩四条腿	丢面子
啄木鸟翻跟头	卖弄花屁股
啄木鸟飞上黄莲树	自讨苦吃
啄木鸟上供桌	卖弄自己
啄木鸟死在树洞里	吃了嘴的亏；全坏在嘴上
啄木鸟修房子	斗嘴劲
啄木鸟栽跟头	吃了嘴上的亏
啄木鸟找食	全凭一张嘴；全凭嘴
啄木鸟治树	人木三分；嘴巴子硬；全仗着嘴硬；全凭嘴
啄未鸟下油锅	嘴硬骨头酥
着火挨板子	两头热
资料室搬家	尽是输（书）；尽输（书）
龇（zi露）牙咧嘴的大虫（老虎）	笑面虎
姊妹俩出嫁	各人忙各人
姊妹找婆家	各得其所
自大加一点	臭
自己跟自己下棋	输也是你赢也是你
自己说的听不见	梦话
自己挖坑埋自己	找死
自家演戏自家看	自我欣赏
自来水坏了龙头	放任自流；任其自流
自留地里拉屎	泄私愤（粪）
自留地里撒尿	肥水不落外人田
自水煮豆腐	淡而无味
自行车下坡	不睬（踩）
自行车下田坎	得过且过
走到渡口打转身	想不过；存心不过了
走江湖的卖假药	招摇撞骗
走近鬼门关	离死不远了
走廊上开铺	不留余地
走了和尚走不了庙	尽管放心
走路拨算盘	手脚不闲
走路换草鞋	喜新厌旧
走路看脚印	太小心
走路拾馒头，摔跟头捡票子	尽想好事；想得倒美
走路拾元宝	机会难得；难得的机会
走路算账	财迷转向
走路轧断腿	半途而废
走亲戚掂牛蹄	两半（瓣）子理（礼）
走煞金刚坐煞佛	苦乐不均
走上步看下步	瞻前顾后
走夜路吹口哨	虚张声势
走一步思三思	考虑周到
奏着唢呐赶毛驴	吹吹拍拍
揍鸡毛	壮但（装掸）子
足球比赛	来回踢
卒子过河	只进不退；死不回头
祖传的被单	破烂不堪
祖传的皮袄	里外孬（nao坏；不好）
祖孙回家	扶老携幼；返老还童
祖宗三代的家务事	一言难尽
祖宗堂里供菩萨	神出鬼没
钻进风箱的耗子	受不完的气
钻进鸟笼里的猫	嘴馋上了当
钻塔顶上观景	站得高，看得远；登高望远
钻头上绑针婆（缝衣针）	尖上拔尖
钻头上加钢针	好厉害
钻在水道眼里叹息	低声下气
钻子碰锉子	对头；死对头
钻子头上加钢针	好厉害
攥（zuan握）着金条进棺材	舍命不舍财
嘴巴搁在锅台上	光等吃
嘴巴含钢针	说话带刺
嘴巴里藏刀子	出口伤人
嘴巴两张皮	咋说咋有理
嘴巴上挂笼嘴	吃不开
嘴巴上挂油瓶	油嘴滑舌
嘴巴上抹蜜	说得甜
嘴巴一张，看得见肚肠	一贫如洗
嘴巴子戏	光说不练
嘴边没毛	办事不牢
嘴唇上贴膏药	免开尊口；开不得口
嘴里吃了烂猪毛	乱糟糟
嘴里没味吃咸鱼	正合胃口
嘴里塞黄连	有苦难诉；有苦说不出
嘴里吞旋风	口气不小
嘴里衔灯草	说得轻巧
嘴皮子抹白糖	说得甜
嘴请客，手关门	虚情假意
嘴上绑喇叭	走到哪儿就吹到哪儿
嘴上挂蒺藜（ji li 一年生草本植物。果皮有尖刺）	说话带刺
嘴上挂天平	说话有分量
嘴上抹石灰	白说；白吃；白刷；白搭
嘴上抹猪油	油嘴滑舌
嘴上贴封条	没说的；没话可说；无话说；闷声不响；不好开口
嘴上贴膏药	不好开口
嘴甜甜，腰里挂弯镰	心术不正
醉汉过铁索桥	上晃下摇
醉汉上街	东倒西歪
醉汉说呓语	难理会
醉汉走路	跌跌撞撞
醉翁之意不在酒	另有所图
左耳朵进，右耳朵出	耳旁风
左话右讲	说反话
左脚穿着右脚鞋	错打错处来
左敲鼓，右打锣	旁敲侧击
左手喇叭右手鼓	自吹自擂
左手买右手卖	不图赚钱只图快
作坊里的石磨	推一推，动一动
作家的书包	里面大有文章
作揖抓脚背	一举两得
坐车不买票	白搭
坐等禾苗黄	懒汉
坐电梯上楼	不怕（爬）
坐飞机抱暖瓶	高水瓶
坐飞机吹喇叭	响得高
坐飞机打靶	高标准
坐飞机打摆子	抖上天了
坐飞机放广播	响彻云霄
坐飞机讲哲学	高谈阔论
坐飞机撵（nian追赶）西北风	大出风头
坐飞机扔相片	丢人不知深浅
坐火箭背喇叭	吹上天了
坐火箭上月球	远走高飞
坐轿打瞌睡	不识抬举
坐轿里骂人	不识抬举
坐轿闷得慌，骑马嫌摇晃	有福不会享
坐木船打阳伞	没天没地
坐南宫守北殿	不分东西
坐上飞机吹喇叭	想（响）得高
坐上飞机钓鱼	差远了
坐在井里的蛤蟆	硬说天只有一个碗大
坐在钱眼儿里摸钱边	财迷心窍
坐着飞机放声唱	高歌猛进
坐着火箭登天	直线上升
座山雕做寿	末日来临
做个大褂丈二宽	大摇（腰）大摆
做了皇帝想成仙	欲无止境
做媒人的赔女儿	输在嘴上
做梦被老虎咬伤	虚惊
做梦变蝴蝶	想人非非（飞飞）
做梦吃扁食（饺子）	想得香
做梦吃大餐	高兴得流出口水
做梦吃黄连	想得苦
做梦吃馒头	梦里见面
做梦吃仙桃	想得倒甜
做梦当长工	想得苦
做梦当皇帝	官迷心窍；好景不长
做梦当司令	神气一时
做梦当总统	好事难成
做梦掉下井	一场虚惊
做梦割破胆	想得苦
做梦捡金条	财迷心窍
做梦见阎王	鬼迷心窍；死去活来
做梦娶西施	想得出奇
做梦娶媳妇	尽想好事；想得倒美；想偏了心；光想美事
做梦拾元宝	空欢喜；欢喜不尽；一场空欢喜；想得美
做梦推磨子	想转了
做梦学吹打	快活一时
做梦游华山	好景不长
做梦游西湖	好景不长
做梦抓大印	官迷心窍
做梦坐飞机	想人非非（飞飞）
做年（旧指干以年计酬的长工活）遇见闰月	倒霉透了；背时
做旗袍用土布	不是那块料
做烧饼的卖汤圆	多面手
做烧饼卖汤圆	多面手
做生意讲信誉	理所当然
做媳妇的没婆婆	好当家
做小本生意	斤斤计较
做贼盗黄连	自讨苦吃
做贼的不用化装	贼眉贼眼
做贼的说梦话	想偷
做贼碰上劫路人	坏到一块了；冤家路窄
做砖的坯子、插刀的鞘子	框框套套